Block,Date,Power_Consumption,Weekday_Number,Month_Number,Original_Forecast,Deviation_original,Absolute_Deviation_original,Absolute_Percentage_Deviation_original,Model_Forecast,Deviation_model,Absolute_Deviation_model,Absolute_Percentage_Deviation_model
1,15-03-2022,13513,1,3,12660,853,853,6.312439873,13397.5,115.5,115.5,0.85473248
2,15-03-2022,13483,1,3,12640,843,843,6.252317733,13396.5,86.5,86.5,0.641548617
3,15-03-2022,13346,1,3,12620,726,726,5.439832159,13403.5,-57.5,57.5,0.430840701
4,15-03-2022,13288,1,3,12600,688,688,5.177603853,13356.5,-68.5,68.5,0.515502709
5,15-03-2022,13200,1,3,12580,620,620,4.696969697,13290.5,-90.5,90.5,0.685606061
6,15-03-2022,13190,1,3,12550,640,640,4.852160728,13138.5,51.5,51.5,0.390447309
7,15-03-2022,13120,1,3,12520,600,600,4.573170732,13158.5,-38.5,38.5,0.293445122
8,15-03-2022,13097,1,3,12500,597,597,4.558295793,13113,-16,16,0.122165381
9,15-03-2022,13031,1,3,12460,571,571,4.381858645,12979,52,52,0.399048423
10,15-03-2022,13031,1,3,12400,631,631,4.842299133,13062.5,-31.5,31.5,0.241731256
11,15-03-2022,12987,1,3,12340,647,647,4.981904982,13075.5,-88.5,88.5,0.681450681
12,15-03-2022,12964,1,3,12300,664,664,5.121875964,13046,-82,82,0.632520827
13,15-03-2022,12917,1,3,12280,637,637,4.931485639,12948.5,-31.5,31.5,0.243864674
14,15-03-2022,12880,1,3,12260,620,620,4.813664596,12697.5,182.5,182.5,1.416925466
15,15-03-2022,12889,1,3,12240,649,649,5.03530142,12741.5,147.5,147.5,1.144386686
16,15-03-2022,12885,1,3,12200,685,685,5.316259216,12621,264,264,2.048894063
17,15-03-2022,12810,1,3,12260,550,550,4.293520687,12388,422,422,3.294301327
18,15-03-2022,12853,1,3,12280,573,573,4.458103167,12529.5,323.5,323.5,2.516922119
19,15-03-2022,12903,1,3,12360,543,543,4.208323646,12682,221,221,1.712779974
20,15-03-2022,12866,1,3,12400,466,466,3.621949324,12642.5,223.5,223.5,1.737136639
21,15-03-2022,12853,1,3,12520,333,333,2.590834825,12666,187,187,1.45491325
22,15-03-2022,12950,1,3,12700,250,250,1.930501931,12877,73,73,0.563706564
23,15-03-2022,13102,1,3,12880,222,222,1.694397802,13046,56,56,0.427415662
24,15-03-2022,13310,1,3,13000,310,310,2.329075883,13027,283,283,2.126220887
25,15-03-2022,13652,1,3,13300,352,352,2.578376795,13301,351,351,2.571051861
26,15-03-2022,14195,1,3,13750,445,445,3.134906657,13874.5,320.5,320.5,2.257837267
27,15-03-2022,14646,1,3,14200,446,446,3.045200055,14380.5,265.5,265.5,1.812781647
28,15-03-2022,15142,1,3,14500,642,642,4.239862634,14672,470,470,3.10394928
29,15-03-2022,15468,1,3,14650,818,818,5.288337212,15162,306,306,1.978277735
30,15-03-2022,15758,1,3,14725,1033,1033,6.555400432,15348.5,409.5,409.5,2.598680036
31,15-03-2022,15903,1,3,14800,1103,1103,6.935798277,15455.5,447.5,447.5,2.813934478
32,15-03-2022,15736,1,3,15300,436,436,2.770716828,15220.5,515.5,515.5,3.275927809
33,15-03-2022,15558,1,3,15240,318,318,2.04396452,15021.5,536.5,536.5,3.448386682
34,15-03-2022,15601,1,3,15150,451,451,2.890840331,14965.5,635.5,635.5,4.07345683
35,15-03-2022,15554,1,3,15060,494,494,3.176031889,14867.5,686.5,686.5,4.413655651
36,15-03-2022,15473,1,3,15000,473,473,3.056937892,14746,727,727,4.698507077
37,15-03-2022,14777,1,3,15020,-243,243,1.644447452,14740,37,37,0.250389118
38,15-03-2022,15002,1,3,15050,-48,48,0.319957339,14975,27,27,0.179976003
39,15-03-2022,15308,1,3,15080,228,228,1.489417298,15063,245,245,1.600470342
40,15-03-2022,15478,1,3,15100,378,378,2.442175992,15284.5,193.5,193.5,1.25016152
41,15-03-2022,15317,1,3,15140,177,177,1.155578769,15190.5,126.5,126.5,0.825879741
42,15-03-2022,15436,1,3,15450,-14,14,0.090697072,15398,38,38,0.246177766
43,15-03-2022,15424,1,3,15540,-116,116,0.752074689,15460,-36,36,0.23340249
44,15-03-2022,15476,1,3,15300,176,176,1.137244766,15408,68,68,0.439390023
45,15-03-2022,15479,1,3,15360,119,119,0.768783513,15074,405,405,2.616448091
46,15-03-2022,15446,1,3,15450,-4,4,0.025896672,15231.5,214.5,214.5,1.388709051
47,15-03-2022,15438,1,3,15540,-102,102,0.660707346,15002.5,435.5,435.5,2.820961264
48,15-03-2022,15923,1,3,15600,323,323,2.028512215,14834.5,1088.5,1088.5,6.836023362
49,15-03-2022,15006,1,3,15560,-554,554,3.691856591,14704,302,302,2.012528322
50,15-03-2022,14933,1,3,15500,-567,567,3.796959754,14892,41,41,0.2745597
51,15-03-2022,14990,1,3,15440,-450,450,3.002001334,14798.5,191.5,191.5,1.277518346
52,15-03-2022,14896,1,3,15400,-504,504,3.383458647,14620.5,275.5,275.5,1.849489796
53,15-03-2022,14666,1,3,15200,-534,534,3.641074594,14386,280,280,1.90917769
54,15-03-2022,14546,1,3,15120,-574,574,3.946102021,14278.5,267.5,267.5,1.838993538
55,15-03-2022,14520,1,3,15080,-560,560,3.856749311,14008.5,511.5,511.5,3.522727273
56,15-03-2022,14676,1,3,15000,-324,324,2.207686018,14326.5,349.5,349.5,2.381439084
57,15-03-2022,14702,1,3,14970,-268,268,1.822881241,14497.5,204.5,204.5,1.390967215
58,15-03-2022,14638,1,3,14850,-212,212,1.448285285,14454.5,183.5,183.5,1.253586556
59,15-03-2022,14621,1,3,14760,-139,139,0.950687367,14256,365,365,2.496409274
60,15-03-2022,14529,1,3,14700,-171,171,1.176956432,14337,192,192,1.321494941
61,15-03-2022,14371,1,3,14700,-329,329,2.289332684,14241,130,130,0.904599541
62,15-03-2022,14399,1,3,14700,-301,301,2.090422946,14358,41,41,0.284741996
63,15-03-2022,14407,1,3,14700,-293,293,2.033733602,14272.5,134.5,134.5,0.933573957
64,15-03-2022,14461,1,3,14700,-239,239,1.652721112,14317,144,144,0.995781758
65,15-03-2022,14554,1,3,14760,-206,206,1.415418442,14623,-69,69,0.474096468
66,15-03-2022,14659,1,3,14850,-191,191,1.302953817,14821,-162,162,1.105123133
67,15-03-2022,14872,1,3,14940,-68,68,0.457235073,15047,-175,175,1.176707907
68,15-03-2022,15180,1,3,15000,180,180,1.185770751,15253,-73,73,0.480895916
69,15-03-2022,15234,1,3,15080,154,154,1.010896678,15319.5,-85.5,85.5,0.561244584
70,15-03-2022,15278,1,3,15200,78,78,0.510538029,15424.5,-146.5,146.5,0.958895143
71,15-03-2022,15339,1,3,15320,19,19,0.123867266,15120,219,219,1.427733229
72,15-03-2022,15469,1,3,15400,69,69,0.446053397,15280,189,189,1.221798436
73,15-03-2022,15428,1,3,15300,128,128,0.829660358,15151.5,276.5,276.5,1.792196007
74,15-03-2022,15701,1,3,15500,201,201,1.280173237,15319.5,381.5,381.5,2.429781543
75,15-03-2022,15943,1,3,15700,243,243,1.524179891,15483.5,459.5,459.5,2.882142633
76,15-03-2022,15372,1,3,15800,-428,428,2.784283112,15315,57,57,0.370804059
77,15-03-2022,15220,1,3,15600,-380,380,2.496714849,15317,-97,97,0.637319317
78,15-03-2022,14983,1,3,15400,-417,417,2.783154241,15073.5,-90.5,90.5,0.604017887
79,15-03-2022,14864,1,3,15030,-166,166,1.11679225,14978,-114,114,0.766953714
80,15-03-2022,14957,1,3,14950,7,7,0.046800829,14856,101,101,0.675269105
81,15-03-2022,14911,1,3,14850,61,61,0.409093957,14625.5,285.5,285.5,1.91469385
82,15-03-2022,14924,1,3,14850,74,74,0.495845618,14617,307,307,2.057089252
83,15-03-2022,14811,1,3,14700,111,111,0.749442982,14421.5,389.5,389.5,2.629802174
84,15-03-2022,14762,1,3,14600,162,162,1.097412275,14411,351,351,2.377726595
85,15-03-2022,14650,1,3,14540,110,110,0.750853242,14272,378,378,2.580204778
86,15-03-2022,14667,1,3,14450,217,217,1.479511829,14123,544,544,3.709006613
87,15-03-2022,14443,1,3,14360,83,83,0.574672852,14087.5,355.5,355.5,2.461399986
88,15-03-2022,14505,1,3,14300,205,205,1.413305757,13879.5,625.5,625.5,4.312306101
89,15-03-2022,13994,1,3,14200,-206,206,1.472059454,13536.5,457.5,457.5,3.269258254
90,15-03-2022,14255,1,3,14050,205,205,1.438091898,13595.5,659.5,659.5,4.626446861
91,15-03-2022,14108,1,3,13900,208,208,1.4743408,13638.5,469.5,469.5,3.327899064
92,15-03-2022,13982,1,3,13800,182,182,1.30167358,13455,527,527,3.769131741
93,15-03-2022,13846,1,3,13700,146,146,1.054456161,13316,530,530,3.827820309
94,15-03-2022,13805,1,3,13550,255,255,1.847156827,13224.5,580.5,580.5,4.204998189
95,15-03-2022,13708,1,3,13400,308,308,2.246863146,13222,486,486,3.545374964
96,15-03-2022,13709,1,3,13300,409,409,2.983441535,13140.5,568.5,568.5,4.146910789
1,16-03-2022,13484,2,3,13620,-136,136,1.008602788,13180.44307,303.55693,303.55693,2.251237986
2,16-03-2022,13374,2,3,13580,-206,206,1.540302079,13135.14397,238.85603,238.85603,1.785973007
3,16-03-2022,13333,2,3,13540,-207,207,1.552538813,13121.66072,211.33928,211.33928,1.585084227
4,16-03-2022,13244,2,3,13500,-256,256,1.93295077,13046.96575,197.03425,197.03425,1.48772463
5,16-03-2022,13197,2,3,13460,-263,263,1.992877169,12902.18247,294.81753,294.81753,2.233973858
6,16-03-2022,13103,2,3,13400,-297,297,2.266656491,12873.96844,229.03156,229.03156,1.747932229
7,16-03-2022,13051,2,3,13340,-289,289,2.214389702,12885.3352,165.6648,165.6648,1.2693648
8,16-03-2022,13063,2,3,13300,-237,237,1.814284621,12917.99248,145.00752,145.00752,1.110062926
9,16-03-2022,12949,2,3,13280,-331,331,2.556181945,12902.38958,46.61042,46.61042,0.359953819
10,16-03-2022,12906,2,3,13250,-344,344,2.665426933,12796.60556,109.39444,109.39444,0.847624671
11,16-03-2022,12889,2,3,13220,-331,331,2.56808131,12732.42849,156.57151,156.57151,1.214768485
12,16-03-2022,12865,2,3,13200,-335,335,2.603964244,12763.96846,101.03154,101.03154,0.785320948
13,16-03-2022,12768,2,3,13140,-372,372,2.913533835,12717.01974,50.98026,50.98026,0.399281485
14,16-03-2022,12831,2,3,13080,-249,249,1.940612579,12663.04337,167.95663,167.95663,1.308990959
15,16-03-2022,12808,2,3,13020,-212,212,1.65521549,12546.45771,261.54229,261.54229,2.042022876
16,16-03-2022,12779,2,3,12900,-121,121,0.946865952,12617.43077,161.56923,161.56923,1.264333907
17,16-03-2022,12735,2,3,12930,-195,195,1.531213192,12648.42792,86.57208,86.57208,0.679796466
18,16-03-2022,12847,2,3,12940,-93,93,0.723904413,12546.53306,300.46694,300.46694,2.33881015
19,16-03-2022,12850,2,3,12980,-130,130,1.011673152,12551.61701,298.38299,298.38299,2.322046615
20,16-03-2022,12899,2,3,13000,-101,101,0.783006435,12586.66975,312.33025,312.33025,2.42135243
21,16-03-2022,12995,2,3,13100,-105,105,0.808003078,12620.353,374.647,374.647,2.88300885
22,16-03-2022,13108,2,3,13250,-142,142,1.083307904,12688.30661,419.69339,419.69339,3.201811031
23,16-03-2022,13201,2,3,13400,-199,199,1.507461556,12785.39246,415.60754,415.60754,3.148303462
24,16-03-2022,13371,2,3,13500,-129,129,0.964774512,12908.61171,462.38829,462.38829,3.458142921
25,16-03-2022,13720,2,3,13760,-40,40,0.29154519,13277.92894,442.07106,442.07106,3.222092274
26,16-03-2022,14293,2,3,14150,143,143,1.00048975,14007.69798,285.30202,285.30202,1.996096131
27,16-03-2022,14808,2,3,14540,268,268,1.809832523,14472.30486,335.69514,335.69514,2.266985008
28,16-03-2022,15240,2,3,14800,440,440,2.887139108,14801.85471,438.14529,438.14529,2.874969094
29,16-03-2022,15546,2,3,14930,616,616,3.962434067,15089.02028,456.97972,456.97972,2.939532484
30,16-03-2022,15748,2,3,14995,753,753,4.781559563,15426.83093,321.16907,321.16907,2.039427673
31,16-03-2022,15784,2,3,15060,724,724,4.586923467,15619.89186,164.10814,164.10814,1.039711987
32,16-03-2022,15726,2,3,16000,-274,274,1.74233753,15414.00937,311.99063,311.99063,1.983915999
33,16-03-2022,15510,2,3,15920,-410,410,2.643455835,15199.68286,310.31714,310.31714,2.000755255
34,16-03-2022,15396,2,3,15800,-404,404,2.624058197,14950.74906,445.25094,445.25094,2.891991037
35,16-03-2022,15313,2,3,15680,-367,367,2.396656436,14975.47503,337.52497,337.52497,2.204172729
36,16-03-2022,15343,2,3,15600,-257,257,1.675030959,15066.53486,276.46514,276.46514,1.801897543
37,16-03-2022,15283,2,3,15600,-317,317,2.074200092,15111.90494,171.09506,171.09506,1.119512269
38,16-03-2022,15428,2,3,15600,-172,172,1.114856106,15510.71144,-82.71144,82.71144,0.536112523
39,16-03-2022,15693,2,3,15600,93,93,0.592620914,15834.61891,-141.61891,141.61891,0.902433633
40,16-03-2022,15818,2,3,15600,218,218,1.378176761,15919.40914,-101.40914,101.40914,0.641099633
41,16-03-2022,15795,2,3,15660,135,135,0.854700855,15786.57547,8.42453,8.42453,0.053336689
42,16-03-2022,15851,2,3,15750,101,101,0.637183774,15622.52201,228.47799,228.47799,1.441410573
43,16-03-2022,15886,2,3,15660,226,226,1.422636284,15520.07827,365.92173,365.92173,2.303422699
44,16-03-2022,15911,2,3,15900,11,11,0.069134561,15417.06778,493.93222,493.93222,3.10434429
45,16-03-2022,15925,2,3,15840,85,85,0.533751962,15356.23258,568.76742,568.76742,3.571537959
46,16-03-2022,16023,2,3,15750,273,273,1.703800786,15208.84313,814.15687,814.15687,5.081176247
47,16-03-2022,16146,2,3,15660,486,486,3.010033445,15231.95367,914.04633,914.04633,5.661131735
48,16-03-2022,15889,2,3,15600,289,289,1.8188684,15020.59365,868.40635,868.40635,5.465456291
49,16-03-2022,16018,2,3,15520,498,498,3.109002372,14865.03022,1152.96978,1152.96978,7.197963416
50,16-03-2022,16041,2,3,15400,641,641,3.996010224,15030.40554,1010.59446,1010.59446,6.300071442
51,16-03-2022,15986,2,3,15280,706,706,4.416364319,14802.39399,1183.60601,1183.60601,7.404016077
52,16-03-2022,16024,2,3,15200,824,824,5.14228657,14731.30743,1292.69257,1292.69257,8.067227721
53,16-03-2022,16005,2,3,15000,1005,1005,6.279287723,14499.18425,1505.81575,1505.81575,9.40840831
54,16-03-2022,16015,2,3,14920,1095,1095,6.837339994,14723.86671,1291.13329,1291.13329,8.062024914
55,16-03-2022,16010,2,3,14880,1130,1130,7.058088695,14624.87862,1385.12138,1385.12138,8.651601374
56,16-03-2022,15334,2,3,14800,534,534,3.482457284,14752.54027,581.45973,581.45973,3.791963806
57,16-03-2022,15672,2,3,14780,892,892,5.691679428,14660.75471,1011.24529,1011.24529,6.452560554
58,16-03-2022,15552,2,3,14700,852,852,5.478395062,14614.70365,937.29635,937.29635,6.026854102
59,16-03-2022,15612,2,3,14640,972,972,6.225980015,14745.45085,866.54915,866.54915,5.550532603
60,16-03-2022,15717,2,3,14600,1117,1117,7.106954253,14697.54695,1019.45305,1019.45305,6.486308138
61,16-03-2022,15665,2,3,14640,1025,1025,6.543249282,14762.09969,902.90031,902.90031,5.763806639
62,16-03-2022,15691,2,3,14700,991,991,6.315722389,14679.81538,1011.18462,1011.18462,6.444360589
63,16-03-2022,15678,2,3,14760,918,918,5.855338691,14750.13989,927.86011,927.86011,5.918230068
64,16-03-2022,15953,2,3,14800,1153,1153,7.227480725,14769.86435,1183.13565,1183.13565,7.416383439
65,16-03-2022,15399,2,3,14920,479,479,3.110591597,14937.16623,461.83377,461.83377,2.999115332
66,16-03-2022,15549,2,3,15100,449,449,2.887645508,15107.1831,441.8169,441.8169,2.841448968
67,16-03-2022,15514,2,3,15280,234,234,1.50831507,15320.87784,193.12216,193.12216,1.244825061
68,16-03-2022,15651,2,3,15400,251,251,1.603731391,15548.94899,102.05101,102.05101,0.652041467
69,16-03-2022,15732,2,3,15460,272,272,1.728960081,15590.40986,141.59014,141.59014,0.900013603
70,16-03-2022,15796,2,3,15550,246,246,1.557356293,15571.21725,224.78275,224.78275,1.423035895
71,16-03-2022,15796,2,3,15640,156,156,0.987591795,15518.77472,277.22528,277.22528,1.755034692
72,16-03-2022,15772,2,3,15700,72,72,0.456505199,15531.52273,240.47727,240.47727,1.524710056
73,16-03-2022,15732,2,3,15500,232,232,1.474701246,15326.71231,405.28769,405.28769,2.576199402
74,16-03-2022,16054,2,3,15700,354,354,2.205057929,15879.18436,174.81564,174.81564,1.088922636
75,16-03-2022,16022,2,3,15900,122,122,0.761453002,15995.47702,26.52298,26.52298,0.165541006
76,16-03-2022,15764,2,3,16000,-236,236,1.497081959,15973.45679,-209.45679,209.45679,1.328703311
77,16-03-2022,15642,2,3,15800,-158,158,1.01010101,15852.0869,-210.0869,210.0869,1.343094873
78,16-03-2022,15405,2,3,15600,-195,195,1.265822785,15679.67754,-274.67754,274.67754,1.78304148
79,16-03-2022,15326,2,3,15560,-234,234,1.526817173,15554.7056,-228.7056,228.7056,1.492271956
80,16-03-2022,15211,2,3,15410,-199,199,1.308263756,15551.55145,-340.55145,340.55145,2.238849846
81,16-03-2022,14972,2,3,15310,-338,338,2.257547422,15250.40576,-278.40576,278.40576,1.859509484
82,16-03-2022,15077,2,3,15150,-73,73,0.484181203,15197.5071,-120.5071,120.5071,0.799277708
83,16-03-2022,14985,2,3,14880,105,105,0.700700701,14869.03637,115.96363,115.96363,0.773864731
84,16-03-2022,15050,2,3,14700,350,350,2.325581395,14615.44618,434.55382,434.55382,2.887400797
85,16-03-2022,14974,2,3,14720,254,254,1.696273541,14834.5973,139.4027,139.4027,0.930965006
86,16-03-2022,15008,2,3,14750,258,258,1.719083156,14854.00317,153.99683,153.99683,1.026098281
87,16-03-2022,14894,2,3,14780,114,114,0.765408889,14800.16608,93.83392,93.83392,0.630011548
88,16-03-2022,14952,2,3,14800,152,152,1.01658641,14684.99977,267.00023,267.00023,1.785715824
89,16-03-2022,14678,2,3,14700,-22,22,0.14988418,14450.43589,227.56411,227.56411,1.55037546
90,16-03-2022,14685,2,3,14550,135,135,0.919305414,14318.3393,366.6607,366.6607,2.49683827
91,16-03-2022,14617,2,3,14400,217,217,1.484572758,14300.29841,316.70159,316.70159,2.166666142
92,16-03-2022,14418,2,3,14300,118,118,0.818421418,14172.92952,245.07048,245.07048,1.699753641
93,16-03-2022,14262,2,3,14240,22,22,0.154256065,14176.23104,85.76896,85.76896,0.601381012
94,16-03-2022,14153,2,3,14150,3,3,0.021196919,14115.72957,37.27043,37.27043,0.263339433
95,16-03-2022,14108,2,3,14060,48,48,0.340232492,14038.90889,69.09111,69.09111,0.489730011
96,16-03-2022,13964,2,3,14000,-36,36,0.257805786,13936.3979,27.6021,27.6021,0.197666142
1,17-03-2022,13958,3,3,13360,598,598,4.284281416,13564.47298,393.52702,393.52702,2.819365382
2,17-03-2022,13843,3,3,13340,503,503,3.633605432,13533.5482,309.4518,309.4518,2.23543885
3,17-03-2022,13765,3,3,13320,445,445,3.232836905,13398.76394,366.23606,366.23606,2.660632474
4,17-03-2022,13659,3,3,13300,359,359,2.628303683,13339.49112,319.50888,319.50888,2.339182078
5,17-03-2022,13577,3,3,13280,297,297,2.187523017,13251.38102,325.61898,325.61898,2.398313177
6,17-03-2022,13412,3,3,13250,162,162,1.207873546,13239.88355,172.11645,172.11645,1.283301894
7,17-03-2022,13366,3,3,13220,146,146,1.092323807,13171.72418,194.27582,194.27582,1.453507556
8,17-03-2022,13369,3,3,13200,169,169,1.264118483,13149.82322,219.17678,219.17678,1.639440347
9,17-03-2022,13245,3,3,13180,65,65,0.490751227,13085.10789,159.89211,159.89211,1.207188448
10,17-03-2022,13194,3,3,13150,44,44,0.333484917,13083.84645,110.15355,110.15355,0.83487608
11,17-03-2022,13257,3,3,13120,137,137,1.033416308,13040.42761,216.57239,216.57239,1.633645546
12,17-03-2022,13211,3,3,13100,111,111,0.840208917,13017.57394,193.42606,193.42606,1.464128832
13,17-03-2022,13158,3,3,13080,78,78,0.592795258,12969.95332,188.04668,188.04668,1.429143335
14,17-03-2022,13107,3,3,13060,47,47,0.358587015,12931.48988,175.51012,175.51012,1.339056382
15,17-03-2022,13112,3,3,13040,72,72,0.549115314,12939.84399,172.15601,172.15601,1.312965299
16,17-03-2022,13170,3,3,13000,170,170,1.290812453,12934.2406,235.7594,235.7594,1.790124525
17,17-03-2022,13082,3,3,13030,52,52,0.397492738,12861.60862,220.39138,220.39138,1.68469179
18,17-03-2022,13119,3,3,13040,79,79,0.602180044,12902.60128,216.39872,216.39872,1.649506212
19,17-03-2022,12957,3,3,13080,-123,123,0.949293818,12947.56759,9.43241,9.43241,0.072797793
20,17-03-2022,13015,3,3,13100,-85,85,0.653092585,12928.49091,86.50909,86.50909,0.664687591
21,17-03-2022,13027,3,3,13200,-173,173,1.328011054,12988,39,39,0.299378214
22,17-03-2022,13137,3,3,13350,-213,213,1.621374743,13099.5,37.5,37.5,0.2854533
23,17-03-2022,13178,3,3,13500,-322,322,2.443466383,13194.0183,-16.0183,16.0183,0.121553346
24,17-03-2022,13306,3,3,13600,-294,294,2.209529536,13375.78621,-69.78621,69.78621,0.524471742
25,17-03-2022,13639,3,3,13900,-261,261,1.913630032,13725.56987,-86.56987,86.56987,0.634723
26,17-03-2022,14201,3,3,14350,-149,149,1.049221886,14281.62944,-80.62944,80.62944,0.567772974
27,17-03-2022,14590,3,3,14800,-210,210,1.439342015,14791,-201,201,1.377655929
28,17-03-2022,15037,3,3,15100,-63,63,0.418966549,15237,-200,200,1.330052537
29,17-03-2022,15486,3,3,15250,236,236,1.523957123,15536.31576,-50.31576,50.31576,0.324911275
30,17-03-2022,15619,3,3,15325,294,294,1.882322812,15781.97342,-162.97342,162.97342,1.043430565
31,17-03-2022,15694,3,3,15400,294,294,1.873327386,15919.73493,-225.73493,225.73493,1.43835179
32,17-03-2022,15446,3,3,16000,-554,554,3.58668911,15750.75892,-304.75892,304.75892,1.973060469
33,17-03-2022,15307,3,3,15940,-633,633,4.135362906,15572.52039,-265.52039,265.52039,1.734633762
34,17-03-2022,15191,3,3,15850,-659,659,4.338094925,15554.50576,-363.50576,363.50576,2.392902113
35,17-03-2022,15089,3,3,15760,-671,671,4.446948108,15515.46119,-426.46119,426.46119,2.826305189
36,17-03-2022,15025,3,3,15700,-675,675,4.492512479,15472.21126,-447.21126,447.21126,2.976447654
37,17-03-2022,14966,3,3,15720,-754,754,5.038086329,15336.58009,-370.58009,370.58009,2.476146532
38,17-03-2022,15068,3,3,15750,-682,682,4.526148128,15621.66224,-553.66224,553.66224,3.67442421
39,17-03-2022,15287,3,3,15780,-493,493,3.224962386,15864.38929,-577.38929,577.38929,3.776995421
40,17-03-2022,15595,3,3,15800,-205,205,1.314523886,16077.20748,-482.20748,482.20748,3.092064636
41,17-03-2022,15733,3,3,15840,-107,107,0.680099155,16008.59255,-275.59255,275.59255,1.751684676
42,17-03-2022,15687,3,3,15850,-163,163,1.039076943,16052.08826,-365.08826,365.08826,2.327330018
43,17-03-2022,15645,3,3,15760,-115,115,0.735059124,16051.06998,-406.06998,406.06998,2.595525599
44,17-03-2022,15666,3,3,16000,-334,334,2.132005617,15991.57182,-325.57182,325.57182,2.078206434
45,17-03-2022,15629,3,3,15940,-311,311,1.989890588,16101.18693,-472.18693,472.18693,3.021222919
46,17-03-2022,15618,3,3,15850,-232,232,1.485465489,16094.5,-476.5,476.5,3.050966833
47,17-03-2022,15633,3,3,15760,-127,127,0.812384059,16144,-511,511,3.268726412
48,17-03-2022,15598,3,3,15700,-102,102,0.653929991,15981.53124,-383.53124,383.53124,2.458848827
49,17-03-2022,15532,3,3,15600,-68,68,0.43780582,15999.33333,-467.33333,467.33333,3.008841939
50,17-03-2022,15615,3,3,15450,165,165,1.056676273,16031,-416,416,2.664105027
51,17-03-2022,15649,3,3,15300,349,349,2.230174452,15984.5,-335.5,335.5,2.143906959
52,17-03-2022,15623,3,3,15200,423,423,2.707546566,16006,-383,383,2.451513794
53,17-03-2022,15158,3,3,15050,108,108,0.712495052,15997,-839,839,5.535031007
54,17-03-2022,15189,3,3,14990,199,199,1.310158667,15987.66667,-798.66667,798.66667,5.258191257
55,17-03-2022,15467,3,3,14960,507,507,3.277946596,16002.66667,-535.66667,535.66667,3.463287451
56,17-03-2022,15409,3,3,14900,509,509,3.303264326,15499.66667,-90.66667,90.66667,0.58840074
57,17-03-2022,15576,3,3,14890,686,686,4.404211608,15716.33333,-140.33333,140.33333,0.900958719
58,17-03-2022,15502,3,3,14850,652,652,4.205908915,15593,-91,91,0.58702103
59,17-03-2022,15353,3,3,14820,533,533,3.471634208,15581.33333,-228.33333,228.33333,1.487222888
60,17-03-2022,15226,3,3,14800,426,426,2.79784579,15695,-469,469,3.080257454
61,17-03-2022,15146,3,3,14820,326,326,2.152383468,15661.66667,-515.66667,515.66667,3.404639311
62,17-03-2022,15084,3,3,14850,234,234,1.551312649,15682.33333,-598.33333,598.33333,3.966675484
63,17-03-2022,15108,3,3,14880,228,228,1.509134234,15628,-520,520,3.441885094
64,17-03-2022,15084,3,3,14900,184,184,1.219835587,15933.66667,-849.66667,849.66667,5.632900225
65,17-03-2022,15283,3,3,15020,263,263,1.720866322,15387.66667,-104.66667,104.66667,0.684856834
66,17-03-2022,15383,3,3,15200,183,183,1.189624911,15532.33333,-149.33333,149.33333,0.970768576
67,17-03-2022,15437,3,3,15380,57,57,0.369242729,15511,-74,74,0.479367753
68,17-03-2022,15434,3,3,15500,-66,66,0.427627316,15650.5,-216.5,216.5,1.402747182
69,17-03-2022,15671,3,3,15540,131,131,0.835938996,15726.5,-55.5,55.5,0.354157361
70,17-03-2022,15686,3,3,15600,86,86,0.548259595,15792,-106,106,0.675761826
71,17-03-2022,15606,3,3,15660,-54,54,0.346020761,15787.5,-181.5,181.5,1.163014225
72,17-03-2022,15692,3,3,15700,-8,8,0.050981392,15767,-75,75,0.477950548
73,17-03-2022,15726,3,3,15700,26,26,0.165331298,15732,-6,6,0.038153377
74,17-03-2022,16159,3,3,15900,259,259,1.602821957,16052.5,106.5,106.5,0.659075438
75,17-03-2022,16254,3,3,16100,154,154,0.947459087,16012,242,242,1.48886428
76,17-03-2022,16162,3,3,16200,-38,38,0.235119416,15772.5,389.5,389.5,2.409974013
77,17-03-2022,15890,3,3,16000,-110,110,0.692259283,15658.5,231.5,231.5,1.456891126
78,17-03-2022,15625,3,3,15800,-175,175,1.12,15478,147,147,0.9408
79,17-03-2022,15524,3,3,15650,-126,126,0.811646483,15389,135,135,0.869621232
80,17-03-2022,15338,3,3,15540,-202,202,1.316990481,15283,55,55,0.358586517
81,17-03-2022,15163,3,3,15440,-277,277,1.826815274,15050.96651,112.03349,112.03349,0.738860977
82,17-03-2022,15155,3,3,15400,-245,245,1.616628176,15070.5,84.5,84.5,0.557571758
83,17-03-2022,15175,3,3,15220,-45,45,0.296540362,14979,196,196,1.291598023
84,17-03-2022,15161,3,3,15100,61,61,0.40234813,15049,112,112,0.73873755
85,17-03-2022,15162,3,3,15100,62,62,0.408917029,14968.5,193.5,193.5,1.276216858
86,17-03-2022,15139,3,3,15100,39,39,0.257612788,14999,140,140,0.924763855
87,17-03-2022,15108,3,3,15100,8,8,0.052952078,14892.5,215.5,215.5,1.426396611
88,17-03-2022,14925,3,3,15100,-175,175,1.172529313,14948.5,-23.5,23.5,0.157453936
89,17-03-2022,14765,3,3,14960,-195,195,1.320690823,14659.5,105.5,105.5,0.714527599
90,17-03-2022,14801,3,3,14750,51,51,0.344571313,14683,118,118,0.797243429
91,17-03-2022,14670,3,3,14540,130,130,0.886162236,14609.5,60.5,60.5,0.412406271
92,17-03-2022,14506,3,3,14400,106,106,0.730732111,14410.5,95.5,95.5,0.65834827
93,17-03-2022,14405,3,3,14300,105,105,0.728913572,14260,145,145,1.006594932
94,17-03-2022,14175,3,3,14150,25,25,0.176366843,14143.5,31.5,31.5,0.222222222
95,17-03-2022,14179,3,3,14000,179,179,1.262430355,14095,84,84,0.592425418
96,17-03-2022,14033,3,3,13900,133,133,0.94776598,13964,69,69,0.49169814
1,18-03-2022,13850,4,3,13880,-30,30,0.216606498,14016.95924,-166.95924,166.95924,1.205481877
2,18-03-2022,13714,4,3,13820,-106,106,0.772932769,13911.65075,-197.65075,197.65075,1.441233411
3,18-03-2022,13626,4,3,13760,-134,134,0.983414061,13826.01491,-200.01491,200.01491,1.467891604
4,18-03-2022,13474,4,3,13700,-226,226,1.677304438,13720.68035,-246.68035,246.68035,1.830787814
5,18-03-2022,13402,4,3,13640,-238,238,1.77585435,13636.53941,-234.53941,234.53941,1.750032906
6,18-03-2022,13349,4,3,13550,-201,201,1.505730766,13497.05321,-148.05321,148.05321,1.109095887
7,18-03-2022,13337,4,3,13460,-123,123,0.922246382,13446.68442,-109.68442,109.68442,0.822406988
8,18-03-2022,13337,4,3,13400,-63,63,0.472370098,13463.05222,-126.05222,126.05222,0.945131739
9,18-03-2022,13266,4,3,13380,-114,114,0.859339665,13334.54676,-68.54676,68.54676,0.516710086
10,18-03-2022,13175,4,3,13350,-175,175,1.328273245,13285.94628,-110.94628,110.94628,0.842097002
11,18-03-2022,13148,4,3,13320,-172,172,1.308183754,13330.42835,-182.42835,182.42835,1.387498859
12,18-03-2022,13179,4,3,13300,-121,121,0.918127324,13296.26936,-117.26936,117.26936,0.889819865
13,18-03-2022,13225,4,3,13260,-35,35,0.264650284,13235.58018,-10.58018,10.58018,0.080001361
14,18-03-2022,13207,4,3,13220,-13,13,0.098432649,13198.97666,8.02334,8.02334,0.060750663
15,18-03-2022,13163,4,3,13180,-17,17,0.12914989,13192.91946,-29.91946,29.91946,0.227299704
16,18-03-2022,13159,4,3,13100,59,59,0.448362338,13230.30322,-71.30322,71.30322,0.541858956
17,18-03-2022,13229,4,3,13130,99,99,0.748355885,13126.77873,102.22127,102.22127,0.772705949
18,18-03-2022,13188,4,3,13140,48,48,0.363967243,13170.99774,17.00226,17.00226,0.128922202
19,18-03-2022,13159,4,3,13180,-21,21,0.159586595,13046.51913,112.48087,112.48087,0.85478281
20,18-03-2022,13081,4,3,13200,-119,119,0.909716383,13086.60263,-5.60263,5.60263,0.042830288
21,18-03-2022,13098,4,3,13260,-162,162,1.23683005,13105.80411,-7.80411,7.80411,0.059582455
22,18-03-2022,13201,4,3,13350,-149,149,1.128702371,13216.6666,-15.6666,15.6666,0.118677373
23,18-03-2022,13300,4,3,13440,-140,140,1.052631579,13288.85671,11.14329,11.14329,0.083784135
24,18-03-2022,13500,4,3,13500,0,0,0,13439.05321,60.94679,60.94679,0.451457704
25,18-03-2022,13705,4,3,13820,-115,115,0.839109814,13776.34656,-71.34656,71.34656,0.520587815
26,18-03-2022,14225,4,3,14300,-75,75,0.527240773,14333.02947,-108.02947,108.02947,0.759433884
27,18-03-2022,14603,4,3,14780,-177,177,1.21207971,14720.92333,-117.92333,117.92333,0.807528111
28,18-03-2022,15051,4,3,15100,-49,49,0.325559763,15188.28337,-137.28337,137.28337,0.912121254
29,18-03-2022,15293,4,3,15260,33,33,0.215785,15600.7316,-307.7316,307.7316,2.012238279
30,18-03-2022,15404,4,3,15340,64,64,0.4154765,15748.82863,-344.82863,344.82863,2.238565502
31,18-03-2022,15525,4,3,15420,105,105,0.676328502,15764.18395,-239.18395,239.18395,1.540637359
32,18-03-2022,15405,4,3,16000,-595,595,3.862382343,15539.60735,-134.60735,134.60735,0.873790003
33,18-03-2022,15205,4,3,15920,-715,715,4.702400526,15392.69945,-187.69945,187.69945,1.234458731
34,18-03-2022,15073,4,3,15800,-727,727,4.82319379,15292.21643,-219.21643,219.21643,1.454364957
35,18-03-2022,14920,4,3,15680,-760,760,5.09383378,15213.09649,-293.09649,293.09649,1.964453686
36,18-03-2022,14893,4,3,15600,-707,707,4.74719667,15155.8395,-262.8395,262.8395,1.764852615
37,18-03-2022,15015,4,3,15640,-625,625,4.162504163,15003.6997,11.3003,11.3003,0.075260073
38,18-03-2022,15228,4,3,15700,-472,472,3.099553454,15106.30636,121.69364,121.69364,0.799143945
39,18-03-2022,15709,4,3,15760,-51,51,0.324654657,15353.7152,355.2848,355.2848,2.261664014
40,18-03-2022,15863,4,3,15800,63,63,0.397150602,15662.73949,200.26051,200.26051,1.262437811
41,18-03-2022,15965,4,3,15840,125,125,0.782962731,15716.40337,248.59663,248.59663,1.557135171
42,18-03-2022,15993,4,3,15850,143,143,0.894141187,15687.99076,305.00924,305.00924,1.907142125
43,18-03-2022,15980,4,3,15760,220,220,1.376720901,15668.72013,311.27987,311.27987,1.947934105
44,18-03-2022,16140,4,3,16000,140,140,0.867410161,15720.21179,419.78821,419.78821,2.600918278
45,18-03-2022,16114,4,3,15940,174,174,1.07980638,15694.71619,419.28381,419.28381,2.601984672
46,18-03-2022,15942,4,3,15850,92,92,0.577091958,15695.37002,246.62998,246.62998,1.547045415
47,18-03-2022,15802,4,3,15760,42,42,0.265789141,15722.24943,79.75057,79.75057,0.504686559
48,18-03-2022,15552,4,3,15700,-148,148,0.951646091,15721.62888,-169.62888,169.62888,1.090720679
49,18-03-2022,15388,4,3,15620,-232,232,1.507668313,15560.78894,-172.78894,172.78894,1.122881076
50,18-03-2022,15404,4,3,15500,-96,96,0.623214749,15626.24934,-222.24934,222.24934,1.442802778
51,18-03-2022,15281,4,3,15380,-99,99,0.64786336,15658.82982,-377.82982,377.82982,2.47254643
52,18-03-2022,15286,4,3,15300,-14,14,0.091587073,15630.88861,-344.88861,344.88861,2.256238453
53,18-03-2022,14971,4,3,15150,-179,179,1.195644913,15241.76095,-270.76095,270.76095,1.808569568
54,18-03-2022,15073,4,3,15090,-17,17,0.112784449,15259.64898,-186.64898,186.64898,1.238300139
55,18-03-2022,15011,4,3,15060,-49,49,0.326427287,15496.4928,-485.4928,485.4928,3.234246886
56,18-03-2022,15051,4,3,15000,51,51,0.338847917,15397.77187,-346.77187,346.77187,2.303978938
57,18-03-2022,15153,4,3,14990,163,163,1.075694582,15536.70519,-383.70519,383.70519,2.532206098
58,18-03-2022,15107,4,3,14950,157,157,1.039253326,15440.71672,-333.71672,333.71672,2.209020454
59,18-03-2022,15121,4,3,14920,201,201,1.329277164,15328.40761,-207.40761,207.40761,1.371652735
60,18-03-2022,15015,4,3,14900,115,115,0.765900766,15225.24754,-210.24754,210.24754,1.400250017
61,18-03-2022,14896,4,3,14940,-44,44,0.29538131,15146.01349,-250.01349,250.01349,1.678393461
62,18-03-2022,14932,4,3,15000,-68,68,0.455397803,15098.51118,-166.51118,166.51118,1.115129788
63,18-03-2022,14905,4,3,15060,-155,155,1.03991949,15113.72912,-208.72912,208.72912,1.400396645
64,18-03-2022,15059,4,3,15100,-41,41,0.272262434,15124.55893,-65.55893,65.55893,0.435347168
65,18-03-2022,15173,4,3,15180,-7,7,0.046134581,15241.6419,-68.6419,68.6419,0.452395044
66,18-03-2022,14995,4,3,15300,-305,305,2.034011337,15350.00236,-355.00236,355.00236,2.367471557
67,18-03-2022,14938,4,3,15420,-482,482,3.226670237,15433.26739,-495.26739,495.26739,3.315486611
68,18-03-2022,15013,4,3,15500,-487,487,3.243855325,15471.6757,-458.6757,458.6757,3.055190169
69,18-03-2022,15023,4,3,15540,-517,517,3.441389869,15675.47992,-652.47992,652.47992,4.34320655
70,18-03-2022,14953,4,3,15600,-647,647,4.326890925,15712.80442,-759.80442,759.80442,5.081284157
71,18-03-2022,14948,4,3,15660,-712,712,4.763179021,15662.08722,-714.08722,714.08722,4.777142226
72,18-03-2022,14842,4,3,15700,-858,858,5.780892063,15755.85378,-913.85378,913.85378,6.157214526
73,18-03-2022,14659,4,3,15600,-941,941,6.419264616,15755.41654,-1096.41654,1096.41654,7.479477045
74,18-03-2022,14731,4,3,15800,-1069,1069,7.256805376,16166.71868,-1435.71868,1435.71868,9.746240445
75,18-03-2022,14828,4,3,16000,-1172,1172,7.903965471,16262.06563,-1434.06563,1434.06563,9.671335514
76,18-03-2022,14742,4,3,16100,-1358,1358,9.211775878,16074.62943,-1332.62943,1332.62943,9.039678673
77,18-03-2022,14588,4,3,15900,-1312,1312,8.993693447,15822.47102,-1234.47102,1234.47102,8.462236222
78,18-03-2022,14411,4,3,15700,-1289,1289,8.944556242,15558.84609,-1147.84609,1147.84609,7.965068975
79,18-03-2022,14438,4,3,15550,-1112,1112,7.70189777,15474.53524,-1036.53524,1036.53524,7.179216235
80,18-03-2022,14339,4,3,15440,-1101,1101,7.678359718,15314.76712,-975.76712,975.76712,6.804987238
81,18-03-2022,14228,4,3,15340,-1112,1112,7.815574923,15135.17995,-907.17995,907.17995,6.376018766
82,18-03-2022,14174,4,3,15300,-1126,1126,7.944123042,15158.153,-984.153,984.153,6.943368139
83,18-03-2022,14115,4,3,15120,-1005,1005,7.120085016,15158.91281,-1043.91281,1043.91281,7.395769111
84,18-03-2022,14071,4,3,15000,-929,929,6.60223154,15155.11685,-1084.11685,1084.11685,7.704618364
85,18-03-2022,14088,4,3,15000,-912,912,6.473594549,15148.18442,-1060.18442,1060.18442,7.525443072
86,18-03-2022,14083,4,3,15000,-917,917,6.511396719,15163.86844,-1080.86844,1080.86844,7.674987148
87,18-03-2022,14083,4,3,15000,-917,917,6.511396719,15114.09739,-1031.09739,1031.09739,7.321574878
88,18-03-2022,14009,4,3,15000,-991,991,7.074023842,14965.01822,-956.01822,956.01822,6.824314512
89,18-03-2022,13832,4,3,14880,-1048,1048,7.576633892,14777.84959,-945.84959,945.84959,6.838126012
90,18-03-2022,13888,4,3,14700,-812,812,5.846774194,14833.30829,-945.30829,945.30829,6.806655314
91,18-03-2022,13827,4,3,14520,-693,693,5.011933174,14704.70377,-877.70377,877.70377,6.34775273
92,18-03-2022,13646,4,3,14400,-754,754,5.525428697,14543.64742,-897.64742,897.64742,6.578099223
93,18-03-2022,13566,4,3,14300,-734,734,5.410585287,14438.15382,-872.15382,872.15382,6.428968156
94,18-03-2022,13443,4,3,14150,-707,707,5.259242729,14259.86681,-816.86681,816.86681,6.076521684
95,18-03-2022,13280,4,3,14000,-720,720,5.421686747,14250.27817,-970.27817,970.27817,7.306311521
96,18-03-2022,13094,4,3,13900,-806,806,6.155491065,14116.2288,-1022.2288,1022.2288,7.806848938
1,19-03-2022,13008,5,3,13520,-512,512,3.93603936,13203.38695,-195.38695,195.38695,1.502052199
2,19-03-2022,13003,5,3,13480,-477,477,3.668384219,13159.05875,-156.05875,156.05875,1.20017496
3,19-03-2022,12808,5,3,13440,-632,632,4.93441599,13070.86458,-262.86458,262.86458,2.052346814
4,19-03-2022,12862,5,3,13400,-538,538,4.182864251,12951.49094,-89.49094,89.49094,0.695777795
5,19-03-2022,12715,5,3,13360,-645,645,5.072748722,12918.90639,-203.90639,203.90639,1.60366803
6,19-03-2022,12634,5,3,13300,-666,666,5.271489631,12886.78329,-252.78329,252.78329,2.000817556
7,19-03-2022,12632,5,3,13240,-608,608,4.813172894,12812.62052,-180.62052,180.62052,1.429864788
8,19-03-2022,12491,5,3,13200,-709,709,5.676086782,12807.61582,-316.61582,316.61582,2.534751581
9,19-03-2022,12438,5,3,13180,-742,742,5.965589323,12751.45945,-313.45945,313.45945,2.520175671
10,19-03-2022,12391,5,3,13150,-759,759,6.125413607,12671.55724,-280.55724,280.55724,2.264201759
11,19-03-2022,12378,5,3,13120,-742,742,5.994506382,12669.6123,-291.6123,291.6123,2.355891905
12,19-03-2022,12341,5,3,13100,-759,759,6.150230938,12669.77307,-328.77307,328.77307,2.66407155
13,19-03-2022,12243,5,3,13080,-837,837,6.836559667,12664.00376,-421.00376,421.00376,3.438730377
14,19-03-2022,11953,5,3,13060,-1107,1107,9.261273321,12619.45837,-666.45837,666.45837,5.575657743
15,19-03-2022,11948,5,3,13040,-1092,1092,9.139604955,12601.79062,-653.79062,653.79062,5.471967024
16,19-03-2022,11874,5,3,13000,-1126,1126,9.482903823,12554.20221,-680.20221,680.20221,5.728501011
17,19-03-2022,11911,5,3,13030,-1119,1119,9.394677189,12578.99685,-667.99685,667.99685,5.608234825
18,19-03-2022,11893,5,3,13040,-1147,1147,9.644328597,12537.44283,-644.44283,644.44283,5.418673421
19,19-03-2022,11902,5,3,13080,-1178,1178,9.897496219,12467.13488,-565.13488,565.13488,4.748234582
20,19-03-2022,12097,5,3,13100,-1003,1003,8.291311896,12469.6237,-372.6237,372.6237,3.080298421
21,19-03-2022,12234,5,3,13180,-946,946,7.732548635,12471.7192,-237.7192,237.7192,1.943102828
22,19-03-2022,12245,5,3,13300,-1055,1055,8.615761535,12537.75422,-292.75422,292.75422,2.390806207
23,19-03-2022,12259,5,3,13420,-1161,1161,9.470593034,12670.1456,-411.1456,411.1456,3.353826576
24,19-03-2022,12354,5,3,13500,-1146,1146,9.276347742,12800.44737,-446.44737,446.44737,3.613788004
25,19-03-2022,12707,5,3,13780,-1073,1073,8.444164634,13110.71275,-403.71275,403.71275,3.1770894
26,19-03-2022,13215,5,3,14200,-985,985,7.453651154,13592.80706,-377.80706,377.80706,2.858925918
27,19-03-2022,13641,5,3,14620,-979,979,7.17689319,14017.43235,-376.43235,376.43235,2.759565648
28,19-03-2022,14145,5,3,14900,-755,755,5.337575115,14448.26987,-303.26987,303.26987,2.144007565
29,19-03-2022,14441,5,3,15040,-599,599,4.147912194,14733.10786,-292.10786,292.10786,2.022767537
30,19-03-2022,14582,5,3,15110,-528,528,3.620902483,14857.39247,-275.39247,275.39247,1.888578179
31,19-03-2022,14960,5,3,15180,-220,220,1.470588235,14992.35838,-32.35838,32.35838,0.216299332
32,19-03-2022,14933,5,3,15800,-867,867,5.805933168,15008.12353,-75.12353,75.12353,0.503070582
33,19-03-2022,14881,5,3,15640,-759,759,5.100463679,14872.61908,8.38092,8.38092,0.056319602
34,19-03-2022,14960,5,3,15400,-440,440,2.941176471,14871.24334,88.75666,88.75666,0.593293182
35,19-03-2022,15052,5,3,15160,-108,108,0.717512623,14852.87831,199.12169,199.12169,1.322891908
36,19-03-2022,15099,5,3,15000,99,99,0.655672561,14867.68545,231.31455,231.31455,1.531985893
37,19-03-2022,15344,5,3,14920,424,424,2.763295099,14924.3591,419.6409,419.6409,2.734885949
38,19-03-2022,15516,5,3,14800,716,716,4.61459139,15154.53653,361.46347,361.46347,2.329617621
39,19-03-2022,15609,5,3,14680,929,929,5.951694535,15410.66952,198.33048,198.33048,1.270616183
40,19-03-2022,15775,5,3,14600,1175,1175,7.448494453,15634.86296,140.13704,140.13704,0.888348906
41,19-03-2022,15895,5,3,14680,1215,1215,7.64391318,15611.11265,283.88735,283.88735,1.786016672
42,19-03-2022,15947,5,3,14900,1047,1047,6.565498213,15694.20307,252.79693,252.79693,1.585231893
43,19-03-2022,15871,5,3,14840,1031,1031,6.496125008,15673.84423,197.15577,197.15577,1.242239115
44,19-03-2022,15874,5,3,15000,874,874,5.505858637,15725.29676,148.70324,148.70324,0.936772332
45,19-03-2022,15763,5,3,14960,803,803,5.094207955,15763.80629,-0.80629,0.80629,0.00511508
46,19-03-2022,15843,5,3,14900,943,943,5.952155526,15622.62805,220.37195,220.37195,1.390973616
47,19-03-2022,15832,5,3,14840,992,992,6.265790803,15494.88212,337.11788,337.11788,2.129344871
48,19-03-2022,15677,5,3,14800,877,877,5.59418256,15328.35109,348.64891,348.64891,2.223951713
49,19-03-2022,15629,5,3,14740,889,889,5.688143835,15183.85234,445.14766,445.14766,2.848215881
50,19-03-2022,15601,5,3,14650,951,951,6.095763092,15172.93081,428.06919,428.06919,2.743857381
51,19-03-2022,15572,5,3,14560,1012,1012,6.498844079,15081.78136,490.21864,490.21864,3.148077575
52,19-03-2022,15442,5,3,14500,942,942,6.100246082,15077.24002,364.75998,364.75998,2.362129128
53,19-03-2022,15400,5,3,14350,1050,1050,6.818181818,14696.25022,703.74978,703.74978,4.569803766
54,19-03-2022,15369,5,3,14290,1079,1079,7.020625935,14745.0368,623.9632,623.9632,4.05988158
55,19-03-2022,15215,5,3,14260,955,955,6.276700624,14811.4484,403.5516,403.5516,2.652327309
56,19-03-2022,15453,5,3,14200,1253,1253,8.108457905,14795.42068,657.57932,657.57932,4.255350547
57,19-03-2022,15380,5,3,14220,1160,1160,7.542262679,14879.97917,500.02083,500.02083,3.251110728
58,19-03-2022,15325,5,3,14300,1025,1025,6.688417618,14759.19494,565.80506,565.80506,3.692039543
59,19-03-2022,15406,5,3,14360,1046,1046,6.789562508,14785.21334,620.78666,620.78666,4.029512268
60,19-03-2022,15352,5,3,14400,952,952,6.20114643,14631.67925,720.32075,720.32075,4.692031983
61,19-03-2022,14899,5,3,14500,399,399,2.678032083,14572.53329,326.46671,326.46671,2.191198805
62,19-03-2022,14974,5,3,14650,324,324,2.163750501,14608.91484,365.08516,365.08516,2.438127154
63,19-03-2022,15004,5,3,14800,204,204,1.35963743,14631.57161,372.42839,372.42839,2.482194015
64,19-03-2022,14926,5,3,14900,26,26,0.174192684,14809.19369,116.80631,116.80631,0.782569409
65,19-03-2022,15011,5,3,14940,71,71,0.472986477,14730.73991,280.26009,280.26009,1.867031444
66,19-03-2022,15025,5,3,15000,25,25,0.166389351,14676.85146,348.14854,348.14854,2.317128386
67,19-03-2022,15143,5,3,15060,83,83,0.548108037,14784.92664,358.07336,358.07336,2.364613089
68,19-03-2022,15230,5,3,15100,130,130,0.853578464,14875.7368,354.2632,354.2632,2.326087984
69,19-03-2022,15091,5,3,15120,-29,29,0.192167517,14900.53321,190.46679,190.46679,1.262121728
70,19-03-2022,15326,5,3,15150,176,176,1.14837531,14860.6239,465.3761,465.3761,3.036513767
71,19-03-2022,15050,5,3,15180,-130,130,0.863787375,14817.66722,232.33278,232.33278,1.543739402
72,19-03-2022,15197,5,3,15200,-3,3,0.019740738,14795.79195,401.20805,401.20805,2.640047707
73,19-03-2022,15004,5,3,15500,-496,496,3.305785124,14693.61685,310.38315,310.38315,2.068669355
74,19-03-2022,15106,5,3,15700,-594,594,3.932212366,14864.62858,241.37142,241.37142,1.597851317
75,19-03-2022,15178,5,3,15900,-722,722,4.756884965,14918.13218,259.86782,259.86782,1.7121348
76,19-03-2022,14973,5,3,16000,-1027,1027,6.85901289,14843.72643,129.27357,129.27357,0.86337788
77,19-03-2022,15095,5,3,15800,-705,705,4.670420669,14691.05009,403.94991,403.94991,2.676051077
78,19-03-2022,14905,5,3,15600,-695,695,4.66286481,14529.5417,375.4583,375.4583,2.519009057
79,19-03-2022,14875,5,3,15230,-355,355,2.386554622,14453.33243,421.66757,421.66757,2.834739966
80,19-03-2022,14799,5,3,15180,-381,381,2.574498277,14391.09772,407.90228,407.90228,2.756282722
81,19-03-2022,14789,5,3,15080,-291,291,1.96767868,14301.92,487.08,487.08,3.293528974
82,19-03-2022,14501,5,3,15200,-699,699,4.820357217,14150.47851,350.52149,350.52149,2.417222881
83,19-03-2022,14269,5,3,15140,-871,871,6.104141846,14072.15756,196.84244,196.84244,1.379511108
84,19-03-2022,14204,5,3,15100,-896,896,6.30808223,14008.95626,195.04374,195.04374,1.373160659
85,19-03-2022,14404,5,3,15040,-636,636,4.415440156,13994.19323,409.80677,409.80677,2.845090044
86,19-03-2022,14405,5,3,14950,-545,545,3.783408539,13908.26252,496.73748,496.73748,3.448368483
87,19-03-2022,14494,5,3,14860,-366,366,2.525182834,13829.19461,664.80539,664.80539,4.586762729
88,19-03-2022,14437,5,3,14800,-363,363,2.514372792,13740.4166,696.5834,696.5834,4.824987186
89,19-03-2022,14415,5,3,14720,-305,305,2.115851544,13558.34914,856.65086,856.65086,5.942773916
90,19-03-2022,14372,5,3,14600,-228,228,1.586418035,13579.79271,792.20729,792.20729,5.512157598
91,19-03-2022,14409,5,3,14480,-71,71,0.492747588,13493.73663,915.26337,915.26337,6.352025609
92,19-03-2022,14305,5,3,14400,-95,95,0.66410346,13358.72089,946.27911,946.27911,6.615023488
93,19-03-2022,13933,5,3,14300,-367,367,2.634034307,13294.12601,638.87399,638.87399,4.585329721
94,19-03-2022,13916,5,3,14150,-234,234,1.681517677,13160.17677,755.82323,755.82323,5.431325309
95,19-03-2022,13748,5,3,14000,-252,252,1.83299389,13026.83153,721.16847,721.16847,5.2456246
96,19-03-2022,13670,5,3,13900,-230,230,1.682516459,12898.24795,771.75205,771.75205,5.645589247
1,20-03-2022,13570,6,3,13540,30,30,0.221075903,13134.64249,435.35751,435.35751,3.208235151
2,20-03-2022,13529,6,3,13460,69,69,0.510015522,13152.29552,376.70448,376.70448,2.784422204
3,20-03-2022,13364,6,3,13380,-16,16,0.119724633,13115.21071,248.78929,248.78929,1.861637908
4,20-03-2022,13342,6,3,13300,42,42,0.314795383,13075.14655,266.85345,266.85345,2.000100809
5,20-03-2022,13204,6,3,13220,-16,16,0.121175401,12982.72176,221.27824,221.27824,1.675842472
6,20-03-2022,13272,6,3,13100,172,172,1.295961423,12925.95797,346.04203,346.04203,2.607308846
7,20-03-2022,13264,6,3,12980,284,284,2.141133896,12869.39535,394.60465,394.60465,2.9750049
8,20-03-2022,13204,6,3,12900,304,304,2.302332626,12844.03857,359.96143,359.96143,2.726154423
9,20-03-2022,13261,6,3,12840,421,421,3.174722872,12813.16342,447.83658,447.83658,3.377095091
10,20-03-2022,13227,6,3,12750,477,477,3.606259923,12797.0442,429.9558,429.9558,3.250591971
11,20-03-2022,13240,6,3,12660,580,580,4.380664653,12756.75091,483.24909,483.24909,3.649917598
12,20-03-2022,13186,6,3,12600,586,586,4.444107387,12770.18761,415.81239,415.81239,3.15343842
13,20-03-2022,13078,6,3,12540,538,538,4.113778865,12736.29944,341.70056,341.70056,2.612789111
14,20-03-2022,12994,6,3,12480,514,514,3.955671849,12471.45841,522.54159,522.54159,4.021406726
15,20-03-2022,12922,6,3,12420,502,502,3.884847547,12466.86126,455.13874,455.13874,3.522200433
16,20-03-2022,12844,6,3,12300,544,544,4.235440673,12414.33489,429.66511,429.66511,3.345259343
17,20-03-2022,12774,6,3,12270,504,504,3.945514326,12334.59651,439.40349,439.40349,3.439826914
18,20-03-2022,12603,6,3,12260,343,343,2.721574228,12345.88569,257.11431,257.11431,2.040104023
19,20-03-2022,12456,6,3,12220,236,236,1.894669236,12334.13176,121.86824,121.86824,0.978389852
20,20-03-2022,12578,6,3,12200,378,378,3.005247257,12349.3833,228.6167,228.6167,1.817591827
21,20-03-2022,12562,6,3,12240,322,322,2.563286101,12351.81498,210.18502,210.18502,1.673181181
22,20-03-2022,12488,6,3,12300,188,188,1.505445227,12456.89001,31.10999,31.10999,0.249119074
23,20-03-2022,12605,6,3,12360,245,245,1.943673146,12454.39305,150.60695,150.60695,1.194819119
24,20-03-2022,12609,6,3,12400,209,209,1.657546197,12436.79197,172.20803,172.20803,1.365754858
25,20-03-2022,12630,6,3,12580,50,50,0.395882819,12561.93167,68.06833,68.06833,0.538941647
26,20-03-2022,12915,6,3,12850,65,65,0.503290747,12875.36853,39.63147,39.63147,0.306863879
27,20-03-2022,13089,6,3,13120,-31,31,0.236840095,13208.98447,-119.98447,119.98447,0.916681717
28,20-03-2022,13383,6,3,13300,83,83,0.620189793,13397.6637,-14.6637,14.6637,0.109569603
29,20-03-2022,13536,6,3,13390,146,146,1.078605201,13675.13845,-139.13845,139.13845,1.027914081
30,20-03-2022,13645,6,3,13435,210,210,1.539025284,13803.65712,-158.65712,158.65712,1.162749139
31,20-03-2022,13799,6,3,13480,319,319,2.311761722,13824.48596,-25.48596,25.48596,0.184694253
32,20-03-2022,13781,6,3,13800,-19,19,0.137870982,13827.45655,-46.45655,46.45655,0.337105798
33,20-03-2022,13793,6,3,13760,33,33,0.239251794,13626.73468,166.26532,166.26532,1.205432611
34,20-03-2022,13806,6,3,13700,106,106,0.767782124,13609.48567,196.51433,196.51433,1.423398015
35,20-03-2022,13668,6,3,13640,28,28,0.204858063,13637.64458,30.35542,30.35542,0.222091162
36,20-03-2022,13696,6,3,13600,96,96,0.700934579,13573.82856,122.17144,122.17144,0.89202278
37,20-03-2022,13679,6,3,13660,19,19,0.138899042,13609.12556,69.87444,69.87444,0.51081541
38,20-03-2022,13754,6,3,13750,4,4,0.029082449,13813.79642,-59.79642,59.79642,0.43475658
39,20-03-2022,13877,6,3,13840,37,37,0.266628234,13955.6928,-78.6928,78.6928,0.567073575
40,20-03-2022,14015,6,3,13900,115,115,0.820549411,14110.15074,-95.15074,95.15074,0.678920728
41,20-03-2022,14064,6,3,13960,104,104,0.739476678,14019.66591,44.33409,44.33409,0.315231015
42,20-03-2022,14091,6,3,14100,-9,9,0.063870556,14160.90645,-69.90645,69.90645,0.49610709
43,20-03-2022,13991,6,3,14040,-49,49,0.350225145,14160.20133,-169.20133,169.20133,1.209358373
44,20-03-2022,14065,6,3,14200,-135,135,0.959829364,14083.46898,-18.46898,18.46898,0.131311625
45,20-03-2022,14255,6,3,14160,95,95,0.666432831,14021.19272,233.80728,233.80728,1.640177341
46,20-03-2022,14240,6,3,14100,140,140,0.983146067,14036.30753,203.69247,203.69247,1.430424649
47,20-03-2022,14185,6,3,14040,145,145,1.022206556,14001.58198,183.41802,183.41802,1.293042087
48,20-03-2022,14085,6,3,14000,85,85,0.603478878,13811.48629,273.51371,273.51371,1.941879375
49,20-03-2022,13847,6,3,13920,-73,73,0.527190005,13676.15978,170.84022,170.84022,1.233770636
50,20-03-2022,13995,6,3,13800,195,195,1.39335477,13812.06918,182.93082,182.93082,1.307115541
51,20-03-2022,14040,6,3,13680,360,360,2.564102564,13750.6749,289.3251,289.3251,2.060720085
52,20-03-2022,14024,6,3,13600,424,424,3.023388477,13632.88154,391.11846,391.11846,2.788922276
53,20-03-2022,14290,6,3,13500,790,790,5.528341498,13476.47321,813.52679,813.52679,5.692979636
54,20-03-2022,14131,6,3,13460,671,671,4.748425448,13386.45003,744.54997,744.54997,5.268912108
55,20-03-2022,13919,6,3,13440,479,479,3.441339177,13327.35596,591.64404,591.64404,4.25062174
56,20-03-2022,13912,6,3,13400,512,512,3.680276021,13225.58663,686.41337,686.41337,4.933966144
57,20-03-2022,13755,6,3,13370,385,385,2.798982188,13067.3154,687.6846,687.6846,4.999524537
58,20-03-2022,13524,6,3,13250,274,274,2.026027802,12955.03961,568.96039,568.96039,4.207042221
59,20-03-2022,13506,6,3,13160,346,346,2.561824374,12709.1803,796.8197,796.8197,5.899746039
60,20-03-2022,13672,6,3,13100,572,572,4.183733177,12594.58781,1077.41219,1077.41219,7.88042854
61,20-03-2022,13460,6,3,13000,460,460,3.417533432,12431.71492,1028.28508,1028.28508,7.639562259
62,20-03-2022,13345,6,3,12850,495,495,3.709254402,12359.12614,985.87386,985.87386,7.387589809
63,20-03-2022,13335,6,3,12700,635,635,4.761904762,12360.34055,974.65945,974.65945,7.309032246
64,20-03-2022,13412,6,3,12600,812,812,6.054279749,12285.27945,1126.72055,1126.72055,8.400839174
65,20-03-2022,13430,6,3,12620,810,810,6.031273269,12360.34819,1069.65181,1069.65181,7.964644899
66,20-03-2022,13482,6,3,12650,832,832,6.171191218,12558.89006,923.10994,923.10994,6.846980715
67,20-03-2022,13453,6,3,12680,773,773,5.745930276,12526.22319,926.77681,926.77681,6.888997324
68,20-03-2022,13229,6,3,12700,529,529,3.998790536,12746.62636,482.37364,482.37364,3.64633487
69,20-03-2022,13287,6,3,12740,547,547,4.116805901,12840.1416,446.8584,446.8584,3.363124859
70,20-03-2022,13376,6,3,12800,576,576,4.306220096,12876.62058,499.37942,499.37942,3.733398774
71,20-03-2022,13388,6,3,12860,528,528,3.943830296,12752.7808,635.2192,635.2192,4.744690768
72,20-03-2022,13470,6,3,12900,570,570,4.231625835,12784.61914,685.38086,685.38086,5.088202376
73,20-03-2022,13327,6,3,12900,427,427,3.20402191,12877.67767,449.32233,449.32233,3.371518946
74,20-03-2022,13320,6,3,13100,220,220,1.651651652,13058.0844,261.9156,261.9156,1.966333333
75,20-03-2022,13518,6,3,13300,218,218,1.612664595,13236.43029,281.56971,281.56971,2.082924323
76,20-03-2022,13535,6,3,13400,135,135,0.997414112,13118.40115,416.59885,416.59885,3.077937569
77,20-03-2022,13567,6,3,13200,367,367,2.705093241,13179.64927,387.35073,387.35073,2.855094936
78,20-03-2022,13509,6,3,13000,509,509,3.767858465,13022.18808,486.81192,486.81192,3.603611814
79,20-03-2022,13424,6,3,13070,354,354,2.637067938,12955.02345,468.97655,468.97655,3.493567864
80,20-03-2022,13263,6,3,12970,293,293,2.209153284,12887.77803,375.22197,375.22197,2.829088215
81,20-03-2022,13260,6,3,12870,390,390,2.941176471,12773.12863,486.87137,486.87137,3.671729789
82,20-03-2022,13326,6,3,12950,376,376,2.821551854,12821.09563,504.90437,504.90437,3.788866652
83,20-03-2022,13327,6,3,12860,467,467,3.504164478,12761.79786,565.20214,565.20214,4.24103054
84,20-03-2022,13424,6,3,12800,624,624,4.648390942,12787.1226,636.8774,636.8774,4.74431913
85,20-03-2022,13501,6,3,12760,741,741,5.488482335,12684.79792,816.20208,816.20208,6.045493519
86,20-03-2022,13549,6,3,12700,849,849,6.266145103,12614.72051,934.27949,934.27949,6.895560484
87,20-03-2022,13313,6,3,12640,673,673,5.055209194,12619.29672,693.70328,693.70328,5.210720949
88,20-03-2022,13128,6,3,12600,528,528,4.021937843,12525.11613,602.88387,602.88387,4.592351234
89,20-03-2022,13075,6,3,12540,535,535,4.091778203,12401.46591,673.53409,673.53409,5.151312352
90,20-03-2022,13087,6,3,12450,637,637,4.86742569,12380.81239,706.18761,706.18761,5.396100023
91,20-03-2022,13007,6,3,12360,647,647,4.974244638,12354.1254,652.8746,652.8746,5.019409549
92,20-03-2022,12865,6,3,12300,565,565,4.391760591,12214.1442,650.8558,650.8558,5.059120093
93,20-03-2022,12737,6,3,12240,497,497,3.902017744,12244.10282,492.89718,492.89718,3.86980592
94,20-03-2022,12672,6,3,12150,522,522,4.119318182,12144.97733,527.02267,527.02267,4.158954151
95,20-03-2022,12475,6,3,12060,415,415,3.326653307,12141.74775,333.25225,333.25225,2.671360721
96,20-03-2022,12430,6,3,12000,430,430,3.459372486,12042.9166,387.0834,387.0834,3.114106195
1,21-03-2022,12408,0,3,12060,348,348,2.804642166,12435.70565,-27.70565,27.70565,0.223288604
2,21-03-2022,12372,0,3,12040,332,332,2.683478823,12380.24771,-8.24771,8.24771,0.066664323
3,21-03-2022,12267,0,3,12020,247,247,2.013532241,12231.59308,35.40692,35.40692,0.288635526
4,21-03-2022,12192,0,3,12000,192,192,1.57480315,12128.48088,63.51912,63.51912,0.520990157
5,21-03-2022,12178,0,3,11980,198,198,1.625882739,12092.56803,85.43197,85.43197,0.701527098
6,21-03-2022,12074,0,3,11950,124,124,1.027000166,12050.91988,23.08012,23.08012,0.191155541
7,21-03-2022,12006,0,3,11920,86,86,0.716308512,12037.11996,-31.11996,31.11996,0.259203398
8,21-03-2022,11963,0,3,11900,63,63,0.526623757,12030.98044,-67.98044,67.98044,0.568255789
9,21-03-2022,11729,0,3,11890,-161,161,1.372666041,11950.57185,-221.57185,221.57185,1.889094126
10,21-03-2022,11590,0,3,11875,-285,285,2.459016393,11896.77049,-306.77049,306.77049,2.646854961
11,21-03-2022,11488,0,3,11860,-372,372,3.23816156,11899.52305,-411.52305,411.52305,3.582199251
12,21-03-2022,11387,0,3,11850,-463,463,4.066040221,11876.0591,-489.0591,489.0591,4.294889787
13,21-03-2022,11467,0,3,11840,-373,373,3.252812418,11815.12567,-348.12567,348.12567,3.035891428
14,21-03-2022,11433,0,3,11830,-397,397,3.472404443,11686.97679,-253.97679,253.97679,2.221436106
15,21-03-2022,11454,0,3,11820,-366,366,3.195390257,11646.29196,-192.29196,192.29196,1.678819277
16,21-03-2022,11460,0,3,11800,-340,340,2.966841187,11570.60359,-110.60359,110.60359,0.965127312
17,21-03-2022,11506,0,3,11890,-384,384,3.337389188,11587.25463,-81.25463,81.25463,0.706193551
18,21-03-2022,11475,0,3,11920,-445,445,3.877995643,11593.02624,-118.02624,118.02624,1.028551111
19,21-03-2022,11461,0,3,12040,-579,579,5.051915191,11540.95785,-79.95785,79.95785,0.697651601
20,21-03-2022,11630,0,3,12100,-470,470,4.041272571,11578.9908,51.0092,51.0092,0.438600172
21,21-03-2022,11772,0,3,12280,-508,508,4.315324499,11724.40397,47.59603,47.59603,0.404315579
22,21-03-2022,11944,0,3,12550,-606,606,5.07367716,11804.88553,139.11447,139.11447,1.164722622
23,21-03-2022,12170,0,3,12820,-650,650,5.341002465,12004.80576,165.19424,165.19424,1.357388989
24,21-03-2022,12415,0,3,13000,-585,585,4.712041885,12300.25812,114.74188,114.74188,0.924219734
25,21-03-2022,12683,0,3,13240,-557,557,4.391705432,12635.71189,47.28811,47.28811,0.372846409
26,21-03-2022,13342,0,3,13600,-258,258,1.933743067,13129.07115,212.92885,212.92885,1.595929021
27,21-03-2022,13812,0,3,13960,-148,148,1.071532001,13545.2227,266.7773,266.7773,1.931489285
28,21-03-2022,14178,0,3,14200,-22,22,0.155169982,14094.68357,83.31643,83.31643,0.58764586
29,21-03-2022,14511,0,3,14320,191,191,1.31624285,14507.37227,3.62773,3.62773,0.024999862
30,21-03-2022,14800,0,3,14380,420,420,2.837837838,14653.09305,146.90695,146.90695,0.992614527
31,21-03-2022,14878,0,3,14440,438,438,2.943944079,14928.9697,-50.9697,50.9697,0.342584353
32,21-03-2022,14887,0,3,14900,-13,13,0.087324511,14840.37479,46.62521,46.62521,0.313194129
33,21-03-2022,14868,0,3,14880,-12,12,0.08071025,14761.49708,106.50292,106.50292,0.71632311
34,21-03-2022,14643,0,3,14850,-207,207,1.413644745,14780.82468,-137.82468,137.82468,0.941232534
35,21-03-2022,14692,0,3,14820,-128,128,0.871222434,14760.3683,-68.3683,68.3683,0.465343724
36,21-03-2022,14753,0,3,14800,-47,47,0.318579272,14760.16795,-7.16795,7.16795,0.048586389
37,21-03-2022,14590,0,3,14920,-330,330,2.261823167,14919.2658,-329.2658,329.2658,2.256790953
38,21-03-2022,14839,0,3,15100,-261,261,1.758878631,15068.57007,-229.57007,229.57007,1.547072377
39,21-03-2022,15129,0,3,15280,-151,151,0.998083152,15180.20721,-51.20721,51.20721,0.338470553
40,21-03-2022,15653,0,3,15400,253,253,1.616303584,15416.27993,236.72007,236.72007,1.512298409
41,21-03-2022,15715,0,3,15520,195,195,1.240852689,15569.52023,145.47977,145.47977,0.925738276
42,21-03-2022,15889,0,3,15900,-11,11,0.069230285,15673.8526,215.1474,215.1474,1.354065076
43,21-03-2022,15930,0,3,15840,90,90,0.564971751,15720.81636,209.18364,209.18364,1.31314275
44,21-03-2022,15906,0,3,16000,-94,94,0.59097196,15667.95804,238.04196,238.04196,1.496554508
45,21-03-2022,15885,0,3,15960,-75,75,0.472143532,15578.6763,306.3237,306.3237,1.928383381
46,21-03-2022,15904,0,3,15900,4,4,0.025150905,15516.65442,387.34558,387.34558,2.435523013
47,21-03-2022,15883,0,3,15840,43,43,0.270729711,15550.46843,332.53157,332.53157,2.093631996
48,21-03-2022,15709,0,3,15800,-91,91,0.57928576,15465.22575,243.77425,243.77425,1.551812655
49,21-03-2022,15588,0,3,15740,-152,152,0.975109058,15370.43182,217.56818,217.56818,1.395741468
50,21-03-2022,15740,0,3,15650,90,90,0.571791614,15253.16392,486.83608,486.83608,3.092986531
51,21-03-2022,15708,0,3,15560,148,148,0.94219506,15460.69804,247.30196,247.30196,1.574369493
52,21-03-2022,15615,0,3,15500,115,115,0.736471342,15331.62104,283.37896,283.37896,1.814786808
53,21-03-2022,15184,0,3,15400,-216,216,1.422550053,15261.03024,-77.03024,77.03024,0.507311907
54,21-03-2022,15393,0,3,15360,33,33,0.214383161,15126.79767,266.20233,266.20233,1.729372637
55,21-03-2022,15264,0,3,15340,-76,76,0.497903564,15054.49803,209.50197,209.50197,1.372523388
56,21-03-2022,15295,0,3,15300,-5,5,0.032690422,15153.61787,141.38213,141.38213,0.92436829
57,21-03-2022,15468,0,3,15270,198,198,1.280062064,15378.25057,89.74943,89.74943,0.580226468
58,21-03-2022,15034,0,3,15150,-116,116,0.771584409,15202.47912,-168.47912,168.47912,1.120653984
59,21-03-2022,15029,0,3,15060,-31,31,0.206267882,15129.96278,-100.96278,100.96278,0.671786413
60,21-03-2022,15013,0,3,15000,13,13,0.086591621,15134.42349,-121.42349,121.42349,0.808788983
61,21-03-2022,15024,0,3,14960,64,64,0.425985091,14779.23213,244.76787,244.76787,1.629179113
62,21-03-2022,14935,0,3,14900,35,35,0.234348845,14729.0849,205.9151,205.9151,1.378741881
63,21-03-2022,14856,0,3,14840,16,16,0.107700592,14762.2743,93.7257,93.7257,0.630894588
64,21-03-2022,14916,0,3,14800,116,116,0.777688388,14930.29984,-14.29984,14.29984,0.095869134
65,21-03-2022,15050,0,3,14840,210,210,1.395348837,15003.90386,46.09614,46.09614,0.306286645
66,21-03-2022,15076,0,3,14900,176,176,1.167418413,14956.77716,119.22284,119.22284,0.790812152
67,21-03-2022,15025,0,3,14960,65,65,0.432612313,14967.39017,57.60983,57.60983,0.383426489
68,21-03-2022,15018,0,3,15000,18,18,0.119856173,15035.9475,-17.9475,17.9475,0.119506592
69,21-03-2022,15070,0,3,15060,10,10,0.066357001,15132.42844,-62.42844,62.42844,0.414256403
70,21-03-2022,15162,0,3,15150,12,12,0.079145231,15266.47996,-104.47996,104.47996,0.689090885
71,21-03-2022,15139,0,3,15240,-101,101,0.667151067,15066.58078,72.41922,72.41922,0.478361979
72,21-03-2022,15105,0,3,15300,-195,195,1.290963257,15108.93987,-3.93987,3.93987,0.026083217
73,21-03-2022,15056,0,3,15200,-144,144,0.95642933,15007.4971,48.5029,48.5029,0.322149973
74,21-03-2022,15192,0,3,15400,-208,208,1.369141654,15084.79176,107.20824,107.20824,0.705688784
75,21-03-2022,15387,0,3,15600,-213,213,1.384285436,15176.10957,210.89043,210.89043,1.370575356
76,21-03-2022,15433,0,3,15700,-267,267,1.730058965,15157.39907,275.60093,275.60093,1.785789736
77,21-03-2022,15222,0,3,15500,-278,278,1.826304034,15041.36803,180.63197,180.63197,1.186650703
78,21-03-2022,15131,0,3,15300,-169,169,1.116912299,14967.13129,163.86871,163.86871,1.082999868
79,21-03-2022,15107,0,3,14930,177,177,1.171642285,14889.72091,217.27909,217.27909,1.438267624
80,21-03-2022,14891,0,3,14810,81,81,0.543952723,14752.81574,138.18426,138.18426,0.927971661
81,21-03-2022,14872,0,3,14710,162,162,1.08929532,14654.44646,217.55354,217.55354,1.462839833
82,21-03-2022,14734,0,3,14550,184,184,1.248812271,14503.27869,230.72131,230.72131,1.565910886
83,21-03-2022,14722,0,3,14280,442,442,3.002309469,14331.28994,390.71006,390.71006,2.653919712
84,21-03-2022,14822,0,3,14100,722,722,4.871137498,14331.50279,490.49721,490.49721,3.309251181
85,21-03-2022,14863,0,3,14140,723,723,4.864428446,14382.91386,480.08614,480.08614,3.230075624
86,21-03-2022,14876,0,3,14200,676,676,4.544232321,14381.54219,494.45781,494.45781,3.323862665
87,21-03-2022,14856,0,3,14260,596,596,4.011847065,14394.33682,461.66318,461.66318,3.107587372
88,21-03-2022,14740,0,3,14300,440,440,2.985074627,14299.5715,440.4285,440.4285,2.987981682
89,21-03-2022,14859,0,3,14160,699,699,4.704219665,14188.69033,670.30967,670.30967,4.51113581
90,21-03-2022,14885,0,3,13950,935,935,6.281491434,14299.71818,585.28182,585.28182,3.93202432
91,21-03-2022,14537,0,3,13740,797,797,5.482561739,14219.51787,317.48213,317.48213,2.18395907
92,21-03-2022,14188,0,3,13600,588,588,4.144347336,14073.40629,114.59371,114.59371,0.807680505
93,21-03-2022,14148,0,3,13480,668,668,4.721515409,13821.10898,326.89102,326.89102,2.310510461
94,21-03-2022,14118,0,3,13300,818,818,5.794021816,13736.95085,381.04915,381.04915,2.69903067
95,21-03-2022,13893,0,3,13120,773,773,5.56395307,13511.51025,381.48975,381.48975,2.74591341
96,21-03-2022,13930,0,3,13000,930,930,6.676238335,13444.26877,485.73123,485.73123,3.486943503
1,22-03-2022,13539,1,3,13060,479,479,3.537927469,13547.41816,-8.41816,8.41816,0.062177118
2,22-03-2022,13533,1,3,13040,493,493,3.642946871,13495.77003,37.22997,37.22997,0.275105076
3,22-03-2022,13402,1,3,13020,382,382,2.850320848,13388.07521,13.92479,13.92479,0.103900836
4,22-03-2022,13338,1,3,13000,338,338,2.53411306,13336.56313,1.43687,1.43687,0.010772755
5,22-03-2022,13285,1,3,12980,305,305,2.295822356,13241.60608,43.39392,43.39392,0.326638464
6,22-03-2022,13192,1,3,12950,242,242,1.834445118,13242.16226,-50.16226,50.16226,0.380247574
7,22-03-2022,13129,1,3,12920,209,209,1.591895803,13186.36274,-57.36274,57.36274,0.436916292
8,22-03-2022,13048,1,3,12900,148,148,1.134273452,13169.28711,-121.28711,121.28711,0.929545601
9,22-03-2022,12944,1,3,12880,64,64,0.494437577,13123.22243,-179.22243,179.22243,1.384598501
10,22-03-2022,12873,1,3,12850,23,23,0.178668531,13083.25146,-210.25146,210.25146,1.633274761
11,22-03-2022,12871,1,3,12820,51,51,0.396239608,13087.52147,-216.52147,216.52147,1.682242794
12,22-03-2022,12823,1,3,12800,23,23,0.179365203,13037.24503,-214.24503,214.24503,1.670787101
13,22-03-2022,12678,1,3,12780,-102,102,0.804543303,12978.16047,-300.16047,300.16047,2.367569569
14,22-03-2022,12635,1,3,12760,-125,125,0.989315394,12933.13385,-298.13385,298.13385,2.359587258
15,22-03-2022,12560,1,3,12740,-180,180,1.433121019,12925.68165,-365.68165,365.68165,2.911478105
16,22-03-2022,12477,1,3,12700,-223,223,1.787288611,12862.52322,-385.52322,385.52322,3.089871123
17,22-03-2022,12316,1,3,12790,-474,474,3.84865216,12790.08608,-474.08608,474.08608,3.849351088
18,22-03-2022,12331,1,3,12820,-489,489,3.965615116,12765.03996,-434.03996,434.03996,3.519908848
19,22-03-2022,12316,1,3,12940,-624,624,5.066580058,12731.41709,-415.41709,415.41709,3.37298709
20,22-03-2022,12404,1,3,13000,-596,596,4.804901645,12808.47987,-404.47987,404.47987,3.260882538
21,22-03-2022,12502,1,3,13180,-678,678,5.423132299,12839.5569,-337.5569,337.5569,2.700023196
22,22-03-2022,12607,1,3,13450,-843,843,6.686761323,12961.18714,-354.18714,354.18714,2.809448243
23,22-03-2022,12709,1,3,13720,-1011,1011,7.954992525,13100.91551,-391.91551,391.91551,3.083763553
24,22-03-2022,13045,1,3,13900,-855,855,6.554235339,13271.8365,-226.8365,226.8365,1.738876964
25,22-03-2022,13356,1,3,14060,-704,704,5.271039233,13519.39476,-163.39476,163.39476,1.223380952
26,22-03-2022,13724,1,3,14300,-576,576,4.197027106,14112.62648,-388.62648,388.62648,2.831728942
27,22-03-2022,14191,1,3,14540,-349,349,2.459305193,14577.04288,-386.04288,386.04288,2.720335988
28,22-03-2022,14534,1,3,14700,-166,166,1.142149443,15047.31334,-513.31334,513.31334,3.531810513
29,22-03-2022,14904,1,3,14780,124,124,0.831991412,15453.64033,-549.64033,549.64033,3.687871243
30,22-03-2022,15072,1,3,14820,252,252,1.671974522,15706.6449,-634.6449,634.6449,4.210754379
31,22-03-2022,15210,1,3,14860,350,350,2.301117686,15832.76705,-622.76705,622.76705,4.094457922
32,22-03-2022,15174,1,3,15500,-326,326,2.148411757,15724.74946,-550.74946,550.74946,3.629560169
33,22-03-2022,15017,1,3,15440,-423,423,2.816807618,15550.0049,-533.0049,533.0049,3.549343411
34,22-03-2022,15056,1,3,15350,-294,294,1.952709883,15418.28032,-362.28032,362.28032,2.406218916
35,22-03-2022,14989,1,3,15260,-271,271,1.807992528,15362.89816,-373.89816,373.89816,2.494483688
36,22-03-2022,15050,1,3,15200,-150,150,0.996677741,15346.2396,-296.2396,296.2396,1.968369435
37,22-03-2022,15036,1,3,15300,-264,264,1.755786113,15202.98332,-166.98332,166.98332,1.110556797
38,22-03-2022,15259,1,3,15450,-191,191,1.251720296,15409.28093,-150.28093,150.28093,0.984867488
39,22-03-2022,15561,1,3,15600,-39,39,0.250626566,15681.7557,-120.7557,120.7557,0.776015038
40,22-03-2022,15631,1,3,15700,-69,69,0.441430491,15915.43533,-284.43533,284.43533,1.819687352
41,22-03-2022,15778,1,3,15760,18,18,0.1140829,15895.17069,-117.17069,117.17069,0.742620674
42,22-03-2022,15901,1,3,15950,-49,49,0.30815672,15896.84098,4.15902,4.15902,0.026155713
43,22-03-2022,15807,1,3,15920,-113,113,0.714873157,15907.19954,-100.19954,100.19954,0.633893465
44,22-03-2022,15925,1,3,16000,-75,75,0.470957614,15904.92319,20.07681,20.07681,0.12607102
45,22-03-2022,15785,1,3,15980,-195,195,1.235350016,15910.10683,-125.10683,125.10683,0.792567818
46,22-03-2022,15961,1,3,15950,11,11,0.068917988,15861.72779,99.27221,99.27221,0.621967358
47,22-03-2022,15910,1,3,15920,-10,10,0.062853551,15833.57157,76.42843,76.42843,0.480379824
48,22-03-2022,15822,1,3,15900,-78,78,0.492984452,15795.54879,26.45121,26.45121,0.167179939
49,22-03-2022,15786,1,3,15840,-54,54,0.342075257,15507.52916,278.47084,278.47084,1.764036741
50,22-03-2022,15761,1,3,15750,11,11,0.069792526,15564.37064,196.62936,196.62936,1.247569063
51,22-03-2022,15682,1,3,15660,22,22,0.140288229,15558.9311,123.0689,123.0689,0.78477809
52,22-03-2022,15720,1,3,15600,120,120,0.763358779,15489.664,230.336,230.336,1.46524173
53,22-03-2022,15355,1,3,15500,-145,145,0.944317812,15334.54944,20.45056,20.45056,0.133185021
54,22-03-2022,15477,1,3,15460,17,17,0.109840408,15332.88117,144.11883,144.11883,0.931180655
55,22-03-2022,15573,1,3,15440,133,133,0.854042253,15219.78265,353.21735,353.21735,2.268139408
56,22-03-2022,15627,1,3,15400,227,227,1.452614065,15348.06547,278.93453,278.93453,1.784952518
57,22-03-2022,15716,1,3,15380,336,336,2.137948587,15381.34945,334.65055,334.65055,2.129362115
58,22-03-2022,15672,1,3,15300,372,372,2.373660031,15298.72708,373.27292,373.27292,2.381782287
59,22-03-2022,15620,1,3,15240,380,380,2.432778489,15338.97958,281.02042,281.02042,1.799106402
60,22-03-2022,15434,1,3,15200,234,234,1.516133212,15323.65776,110.34224,110.34224,0.714929636
61,22-03-2022,15512,1,3,15180,332,332,2.140278494,15140.00171,371.99829,371.99829,2.398132349
62,22-03-2022,15261,1,3,15150,111,111,0.727344211,15187.31756,73.68244,73.68244,0.482815281
63,22-03-2022,15264,1,3,15120,144,144,0.943396226,15142.24783,121.75217,121.75217,0.797642623
64,22-03-2022,15351,1,3,15100,251,251,1.635072634,15311.28091,39.71909,39.71909,0.258739431
65,22-03-2022,15421,1,3,15140,281,281,1.822190519,15395.45029,25.54971,25.54971,0.165681279
66,22-03-2022,15462,1,3,15200,262,262,1.694476782,15497.16628,-35.16628,35.16628,0.227436813
67,22-03-2022,15627,1,3,15260,367,367,2.348499392,15622.06379,4.93621,4.93621,0.031587701
68,22-03-2022,15660,1,3,15300,360,360,2.298850575,15664.3907,-4.3907,4.3907,0.028037676
69,22-03-2022,15718,1,3,15360,358,358,2.277643466,15672.37878,45.62122,45.62122,0.29024825
70,22-03-2022,15839,1,3,15450,389,389,2.455963129,15739.63925,99.36075,99.36075,0.627317065
71,22-03-2022,15880,1,3,15540,340,340,2.141057935,15700.35479,179.64521,179.64521,1.131267065
72,22-03-2022,15727,1,3,15600,127,127,0.807528454,15768.18805,-41.18805,41.18805,0.261893877
73,22-03-2022,15614,1,3,15500,114,114,0.730114,15563.49648,50.50352,50.50352,0.323450237
74,22-03-2022,15801,1,3,15700,101,101,0.639200051,15704.35447,96.64553,96.64553,0.611641858
75,22-03-2022,15977,1,3,15900,77,77,0.481942793,15873.55059,103.44941,103.44941,0.647489579
76,22-03-2022,15951,1,3,16000,-49,49,0.307190772,15751.54238,199.45762,199.45762,1.250439596
77,22-03-2022,15737,1,3,15800,-63,63,0.400330431,15686.42087,50.57913,50.57913,0.321402618
78,22-03-2022,15722,1,3,15600,122,122,0.775982699,15515.53501,206.46499,206.46499,1.313223445
79,22-03-2022,15586,1,3,15340,246,246,1.578339535,15369.9758,216.0242,216.0242,1.386014372
80,22-03-2022,15538,1,3,15260,278,278,1.789162054,15174.64246,363.35754,363.35754,2.338509075
81,22-03-2022,15474,1,3,15160,314,314,2.029210288,15069.49801,404.50199,404.50199,2.614075158
82,22-03-2022,15519,1,3,15200,319,319,2.055544816,14978.07099,540.92901,540.92901,3.48559192
83,22-03-2022,15478,1,3,15080,398,398,2.571391653,14852.9739,625.0261,625.0261,4.038158031
84,22-03-2022,15489,1,3,15000,489,489,3.157079218,14792.12141,696.87859,696.87859,4.499183872
85,22-03-2022,15499,1,3,15000,499,499,3.219562552,14734.02326,764.97674,764.97674,4.935652236
86,22-03-2022,15236,1,3,15000,236,236,1.548962982,14742.7726,493.2274,493.2274,3.237249934
87,22-03-2022,15421,1,3,15000,421,421,2.730043447,14580.74333,840.25667,840.25667,5.448781986
88,22-03-2022,15483,1,3,15000,483,483,3.119550475,14452.67969,1030.32031,1030.32031,6.654526319
89,22-03-2022,14912,1,3,14820,92,92,0.61695279,14222.14823,689.85177,689.85177,4.626151891
90,22-03-2022,15151,1,3,14550,601,601,3.966734869,14204.19099,946.80901,946.80901,6.249151937
91,22-03-2022,14830,1,3,14280,550,550,3.708698584,14142.48992,687.51008,687.51008,4.6359412
92,22-03-2022,14658,1,3,14100,558,558,3.806794924,14012.41105,645.58895,645.58895,4.404345409
93,22-03-2022,14110,1,3,13940,170,170,1.204819277,13871.13085,238.86915,238.86915,1.692906804
94,22-03-2022,14292,1,3,13700,592,592,4.142177442,13793.35384,498.64616,498.64616,3.488987965
95,22-03-2022,13770,1,3,13460,310,310,2.251270879,13675.1929,94.8071,94.8071,0.68850472
96,22-03-2022,14048,1,3,13300,748,748,5.324601367,13601.66393,446.33607,446.33607,3.177221455
1,23-03-2022,13783,2,3,13680,103,103,0.747297395,13674.70217,108.29783,108.29783,0.785734818
2,23-03-2022,13702,2,3,13620,82,82,0.598452781,13648.37961,53.62039,53.62039,0.391332579
3,23-03-2022,13757,2,3,13560,197,197,1.431998255,13509.5695,247.4305,247.4305,1.798578905
4,23-03-2022,13747,2,3,13500,247,247,1.796755656,13433.4495,313.5505,313.5505,2.280864916
5,23-03-2022,13556,2,3,13440,116,116,0.855709649,13331.09297,224.90703,224.90703,1.659095825
6,23-03-2022,13581,2,3,13350,231,231,1.700905677,13259.50853,321.49147,321.49147,2.367215006
7,23-03-2022,13534,2,3,13260,274,274,2.024530811,13234.37029,299.62971,299.62971,2.213903576
8,23-03-2022,13468,2,3,13200,268,268,1.98990199,13130.29196,337.70804,337.70804,2.507484704
9,23-03-2022,13468,2,3,13140,328,328,2.435402435,13053.17944,414.82056,414.82056,3.080045738
10,23-03-2022,13423,2,3,13050,373,373,2.778812486,12964.61474,458.38526,458.38526,3.414924086
11,23-03-2022,13507,2,3,12960,547,547,4.04975198,12877.69341,629.30659,629.30659,4.659114459
12,23-03-2022,13454,2,3,12900,554,554,4.117734503,12890.52936,563.47064,563.47064,4.188127248
13,23-03-2022,13419,2,3,12880,539,539,4.016692749,12782.56671,636.43329,636.43329,4.742777331
14,23-03-2022,13228,2,3,12860,368,368,2.781977623,12725.71114,502.28886,502.28886,3.797164046
15,23-03-2022,13128,2,3,12840,288,288,2.193784278,12639.34617,488.65383,488.65383,3.722226005
16,23-03-2022,13087,2,3,12800,287,287,2.19301597,12595.12222,491.87778,491.87778,3.758522045
17,23-03-2022,13073,2,3,12860,213,213,1.629312323,12409.63968,663.36032,663.36032,5.074277672
18,23-03-2022,13180,2,3,12880,300,300,2.276176024,12455.35653,724.64347,724.64347,5.498053642
19,23-03-2022,13116,2,3,12960,156,156,1.189387008,12455.33251,660.66749,660.66749,5.037111086
20,23-03-2022,13037,2,3,13000,37,37,0.283807624,12535.73447,501.26553,501.26553,3.844945386
21,23-03-2022,13066,2,3,13100,-34,34,0.260217358,12677.61287,388.38713,388.38713,2.972502143
22,23-03-2022,13283,2,3,13250,33,33,0.248437853,12744.51923,538.48077,538.48077,4.053909283
23,23-03-2022,13492,2,3,13400,92,92,0.681885562,12870.72196,621.27804,621.27804,4.604788319
24,23-03-2022,13676,2,3,13500,176,176,1.286926002,13196.99328,479.00672,479.00672,3.502535244
25,23-03-2022,13875,2,3,13760,115,115,0.828828829,13498.97562,376.02438,376.02438,2.710085622
26,23-03-2022,14367,2,3,14150,217,217,1.510405791,13854.47588,512.52412,512.52412,3.567370502
27,23-03-2022,14847,2,3,14540,307,307,2.067757796,14329.31479,517.68521,517.68521,3.486800094
28,23-03-2022,15156,2,3,14800,356,356,2.348904724,14612.6596,543.3404,543.3404,3.584985484
29,23-03-2022,15529,2,3,14930,599,599,3.857299247,14858.424,670.576,670.576,4.318217528
30,23-03-2022,15721,2,3,14995,726,726,4.618026843,15093.48565,627.51435,627.51435,3.991567648
31,23-03-2022,15737,2,3,15060,677,677,4.301963525,15258.23401,478.76599,478.76599,3.042295164
32,23-03-2022,15580,2,3,15500,80,80,0.513478819,15209.10234,370.89766,370.89766,2.380601155
33,23-03-2022,15471,2,3,15440,31,31,0.200374895,15070.38268,400.61732,400.61732,2.589472691
34,23-03-2022,15339,2,3,15350,-11,11,0.071712628,15084.82298,254.17702,254.17702,1.657063824
35,23-03-2022,15418,2,3,15260,158,158,1.024776236,14996.35319,421.64681,421.64681,2.734769815
36,23-03-2022,15301,2,3,15200,101,101,0.660087576,15048.45913,252.54087,252.54087,1.650486047
37,23-03-2022,15412,2,3,15300,112,112,0.726706462,15105.78271,306.21729,306.21729,1.986875746
38,23-03-2022,15839,2,3,15450,389,389,2.455963129,15323.12047,515.87953,515.87953,3.257020835
39,23-03-2022,15938,2,3,15600,338,338,2.120717781,15573.26049,364.73951,364.73951,2.288489836
40,23-03-2022,16215,2,3,15700,515,515,3.176071539,15666.55353,548.44647,548.44647,3.382340241
41,23-03-2022,16246,2,3,15780,466,466,2.868398375,15748.89392,497.10608,497.10608,3.059867537
42,23-03-2022,16319,2,3,16000,319,319,1.954776641,15832.51379,486.48621,486.48621,2.98110307
43,23-03-2022,16525,2,3,15940,585,585,3.540090772,15703.11454,821.88546,821.88546,4.97358826
44,23-03-2022,16475,2,3,16100,375,375,2.276176024,15894.67134,580.32866,580.32866,3.522480486
45,23-03-2022,16260,2,3,16060,200,200,1.2300123,15675.78752,584.21248,584.21248,3.592942681
46,23-03-2022,16261,2,3,16000,261,261,1.605067339,15858.58558,402.41442,402.41442,2.474721235
47,23-03-2022,16314,2,3,15940,374,374,2.292509501,16009.93845,304.06155,304.06155,1.863807466
48,23-03-2022,16397,2,3,15900,497,497,3.031042264,15741.28719,655.71281,655.71281,3.998980362
49,23-03-2022,16129,2,3,15840,289,289,1.791803584,15799.95666,329.04334,329.04334,2.040072788
50,23-03-2022,16232,2,3,15750,482,482,2.969443075,15871.44956,360.55044,360.55044,2.22123238
51,23-03-2022,16239,2,3,15660,579,579,3.565490486,15614.06859,624.93141,624.93141,3.848336782
52,23-03-2022,16315,2,3,15600,715,715,4.38247012,15735.01062,579.98938,579.98938,3.554945633
53,23-03-2022,16129,2,3,15500,629,629,3.8998078,15430.48806,698.51194,698.51194,4.33078269
54,23-03-2022,16075,2,3,15460,615,615,3.825816485,15482.83029,592.16971,592.16971,3.683792908
55,23-03-2022,16144,2,3,15440,704,704,4.360753221,15500.38593,643.61407,643.61407,3.986707569
56,23-03-2022,16007,2,3,15400,607,607,3.79209096,15450.11779,556.88221,556.88221,3.478991754
57,23-03-2022,15907,2,3,15360,547,547,3.438737663,15536.99264,370.00736,370.00736,2.32606626
58,23-03-2022,16052,2,3,15200,852,852,5.307749813,15581.45695,470.54305,470.54305,2.931367119
59,23-03-2022,15942,2,3,15080,862,862,5.40710074,15449.97309,492.02691,492.02691,3.086356229
60,23-03-2022,15779,2,3,15000,779,779,4.936941505,15277.61806,501.38194,501.38194,3.177526713
61,23-03-2022,15635,2,3,14980,655,655,4.189318836,15398.69098,236.30902,236.30902,1.511410425
62,23-03-2022,15525,2,3,14950,575,575,3.703703704,15152.61039,372.38961,372.38961,2.398644831
63,23-03-2022,15374,2,3,14920,454,454,2.953037596,15154.58708,219.41292,219.41292,1.427168726
64,23-03-2022,15398,2,3,14900,498,498,3.234186258,15144.80831,253.19169,253.19169,1.644315431
65,23-03-2022,15058,2,3,14960,98,98,0.650816842,15156.83137,-98.83137,98.83137,0.65633796
66,23-03-2022,15073,2,3,15050,23,23,0.152590725,15204.98407,-131.98407,131.98407,0.875632389
67,23-03-2022,15085,2,3,15140,-55,55,0.364600597,15361.35435,-276.35435,276.35435,1.831981107
68,23-03-2022,15123,2,3,15200,-77,77,0.509158236,15321.60937,-198.60937,198.60937,1.31329346
69,23-03-2022,15054,2,3,15240,-186,186,1.235552013,15444.7003,-390.7003,390.7003,2.595325495
70,23-03-2022,15236,2,3,15300,-64,64,0.420057758,15572.16997,-336.16997,336.16997,2.206418811
71,23-03-2022,15281,2,3,15360,-79,79,0.516981873,15510.75746,-229.75746,229.75746,1.503549899
72,23-03-2022,15398,2,3,15400,-2,2,0.0129887,15281.54259,116.45741,116.45741,0.756315171
73,23-03-2022,15530,2,3,15400,130,130,0.837089504,15230.98616,299.01384,299.01384,1.925394977
74,23-03-2022,15698,2,3,15600,98,98,0.624283348,15653.72687,44.27313,44.27313,0.282030386
75,23-03-2022,15707,2,3,15800,-93,93,0.592092698,15830.41962,-123.41962,123.41962,0.78576189
76,23-03-2022,15593,2,3,15900,-307,307,1.968832168,15700.34008,-107.34008,107.34008,0.688386327
77,23-03-2022,15395,2,3,15700,-305,305,1.981162715,15494.98496,-99.98496,99.98496,0.649463852
78,23-03-2022,15307,2,3,15500,-193,193,1.260861044,15477.62756,-170.62756,170.62756,1.114702816
79,23-03-2022,15270,2,3,15460,-190,190,1.24426981,15406.25451,-136.25451,136.25451,0.892301965
80,23-03-2022,15104,2,3,15380,-276,276,1.827330508,15372.6097,-268.6097,268.6097,1.778401086
81,23-03-2022,14950,2,3,15280,-330,330,2.20735786,15281.55478,-331.55478,331.55478,2.217757726
82,23-03-2022,14985,2,3,15400,-415,415,2.769436103,15321.66085,-336.66085,336.66085,2.246652319
83,23-03-2022,15076,2,3,15340,-264,264,1.75112762,15317.64882,-241.64882,241.64882,1.602870921
84,23-03-2022,15103,2,3,15300,-197,197,1.304376614,15308.11263,-205.11263,205.11263,1.358091968
85,23-03-2022,15122,2,3,15240,-118,118,0.780320063,15266.23928,-144.23928,144.23928,0.953837323
86,23-03-2022,15259,2,3,15150,109,109,0.714332525,15099.79124,159.20876,159.20876,1.043376106
87,23-03-2022,15298,2,3,15060,238,238,1.555758923,15227.51323,70.48677,70.48677,0.460758073
88,23-03-2022,15329,2,3,15000,329,329,2.146258725,15278.68927,50.31073,50.31073,0.32820621
89,23-03-2022,15195,2,3,14840,355,355,2.336294834,14801.89053,393.10947,393.10947,2.587097532
90,23-03-2022,15252,2,3,14600,652,652,4.2748492,15043.33342,208.66658,208.66658,1.368126016
91,23-03-2022,15001,2,3,14360,641,641,4.273048463,14771.24031,229.75969,229.75969,1.531629158
92,23-03-2022,14807,2,3,14200,607,607,4.09941244,14608.38368,198.61632,198.61632,1.341367731
93,23-03-2022,14592,2,3,14160,432,432,2.960526316,14137.63613,454.36387,454.36387,3.113787486
94,23-03-2022,14437,2,3,14100,337,337,2.334279975,14321.21022,115.78978,115.78978,0.80203491
95,23-03-2022,14238,2,3,14040,198,198,1.390644753,13812.18933,425.81067,425.81067,2.990663506
96,23-03-2022,14007,2,3,14000,7,7,0.049975012,14094.57842,-87.57842,87.57842,0.625247519
1,24-03-2022,13859,3,3,13920,-61,61,0.440147197,13565.12888,293.87112,293.87112,2.120435241
2,24-03-2022,13734,3,3,13880,-146,146,1.063055191,13453.20247,280.79753,280.79753,2.044542959
3,24-03-2022,13628,3,3,13840,-212,212,1.555620781,13396.97646,231.02354,231.02354,1.695212357
4,24-03-2022,13547,3,3,13800,-253,253,1.867572156,13303.22797,243.77203,243.77203,1.799453975
5,24-03-2022,13374,3,3,13760,-386,386,2.886197099,13201.92517,172.07483,172.07483,1.286636982
6,24-03-2022,13357,3,3,13700,-343,343,2.567941903,13090.93763,266.06237,266.06237,1.991932096
7,24-03-2022,13298,3,3,13640,-342,342,2.571815311,13069.16269,228.83731,228.83731,1.720840051
8,24-03-2022,13287,3,3,13600,-313,313,2.355686009,13044.90744,242.09256,242.09256,1.822025739
9,24-03-2022,13220,3,3,13560,-340,340,2.571860817,12924.27791,295.72209,295.72209,2.236929576
10,24-03-2022,13124,3,3,13500,-376,376,2.864980189,12874.22893,249.77107,249.77107,1.903162679
11,24-03-2022,13226,3,3,13440,-214,214,1.618025102,12895.35534,330.64466,330.64466,2.499959625
12,24-03-2022,13204,3,3,13400,-196,196,1.484398667,12853.45511,350.54489,350.54489,2.65483861
13,24-03-2022,13164,3,3,13360,-196,196,1.488909146,12823.36845,340.63155,340.63155,2.587599134
14,24-03-2022,13179,3,3,13320,-141,141,1.069883906,12758.84548,420.15452,420.15452,3.188060703
15,24-03-2022,13132,3,3,13280,-148,148,1.127017971,12786.63727,345.36273,345.36273,2.629932455
16,24-03-2022,13158,3,3,13200,-42,42,0.319197446,12826.10437,331.89563,331.89563,2.522386609
17,24-03-2022,13071,3,3,13290,-219,219,1.675464769,12841.3125,229.6875,229.6875,1.757229745
18,24-03-2022,13050,3,3,13320,-270,270,2.068965517,12689.66072,360.33928,360.33928,2.761220536
19,24-03-2022,13010,3,3,13440,-430,430,3.305149885,12614.06988,395.93012,395.93012,3.043275327
20,24-03-2022,13092,3,3,13500,-408,408,3.116406966,12734.90262,357.09738,357.09738,2.727599908
21,24-03-2022,13088,3,3,13640,-552,552,4.217603912,12774.22221,313.77779,313.77779,2.397446439
22,24-03-2022,13161,3,3,13850,-689,689,5.235164501,12862.68089,298.31911,298.31911,2.266690297
23,24-03-2022,13351,3,3,14060,-709,709,5.310463636,12946.12847,404.87153,404.87153,3.032518388
24,24-03-2022,13455,3,3,14200,-745,745,5.536975102,13177.37217,277.62783,277.62783,2.063380379
25,24-03-2022,13702,3,3,14400,-698,698,5.09414684,13536.8363,165.1637,165.1637,1.205398482
26,24-03-2022,14209,3,3,14700,-491,491,3.455556338,14014.93699,194.06301,194.06301,1.365775283
27,24-03-2022,14657,3,3,15000,-343,343,2.340178754,14662.0659,-5.0659,5.0659,0.034563007
28,24-03-2022,15002,3,3,15200,-198,198,1.319824023,15097.92276,-95.92276,95.92276,0.639399813
29,24-03-2022,15274,3,3,15300,-26,26,0.17022391,15433.65513,-159.65513,159.65513,1.045273864
30,24-03-2022,15468,3,3,15350,118,118,0.76286527,15613.82083,-145.82083,145.82083,0.942725821
31,24-03-2022,15583,3,3,15400,183,183,1.174356671,15516.6974,66.3026,66.3026,0.425480331
32,24-03-2022,15474,3,3,16000,-526,526,3.399250355,15286.24691,187.75309,187.75309,1.213345547
33,24-03-2022,15305,3,3,15960,-655,655,4.279647174,15296.88173,8.11827,8.11827,0.053043254
34,24-03-2022,15165,3,3,15900,-735,735,4.846686449,15196.18146,-31.18146,31.18146,0.205614639
35,24-03-2022,15264,3,3,15840,-576,576,3.773584906,15249.28753,14.71247,14.71247,0.096386727
36,24-03-2022,15216,3,3,15800,-584,584,3.838065195,15162.80365,53.19635,53.19635,0.349607978
37,24-03-2022,15242,3,3,15840,-598,598,3.923369637,15149.25358,92.74642,92.74642,0.608492455
38,24-03-2022,15505,3,3,15900,-395,395,2.547565302,15320.20361,184.79639,184.79639,1.191850306
39,24-03-2022,15759,3,3,15960,-201,201,1.275461641,15608.22678,150.77322,150.77322,0.956743575
40,24-03-2022,15964,3,3,16000,-36,36,0.225507392,15900.304,63.696,63.696,0.398997745
41,24-03-2022,16004,3,3,16080,-76,76,0.47488128,15956.51559,47.48441,47.48441,0.296703387
42,24-03-2022,16187,3,3,16300,-113,113,0.698091061,15817.08126,369.91874,369.91874,2.285282881
43,24-03-2022,16118,3,3,16240,-122,122,0.756917732,15770.01617,347.98383,347.98383,2.158976486
44,24-03-2022,16334,3,3,16400,-66,66,0.40406514,15975.57463,358.42537,358.42537,2.194351475
45,24-03-2022,16374,3,3,16360,14,14,0.085501405,15813.77762,560.22238,560.22238,3.421414315
46,24-03-2022,16414,3,3,16300,114,114,0.694529061,15934.56162,479.43838,479.43838,2.920911295
47,24-03-2022,16305,3,3,16240,65,65,0.398650721,15813.64453,491.35547,491.35547,3.013526342
48,24-03-2022,16239,3,3,16200,39,39,0.240162572,15850.89965,388.10035,388.10035,2.389927643
49,24-03-2022,16310,3,3,16140,170,170,1.042305334,15887.76279,422.23721,422.23721,2.588824096
50,24-03-2022,16274,3,3,16050,224,224,1.376428659,15822.22452,451.77548,451.77548,2.776056778
51,24-03-2022,16253,3,3,15960,293,293,1.802744109,15724.09011,528.90989,528.90989,3.254229312
52,24-03-2022,15748,3,3,15900,-152,152,0.96520193,15808.15225,-60.15225,60.15225,0.381967551
53,24-03-2022,15698,3,3,15750,-52,52,0.331252389,15321.4557,376.5443,376.5443,2.398676902
54,24-03-2022,15661,3,3,15690,-29,29,0.185173361,15392.13253,268.86747,268.86747,1.716796309
55,24-03-2022,15716,3,3,15660,56,56,0.356324765,15707.45143,8.54857,8.54857,0.054394057
56,24-03-2022,15713,3,3,15600,113,113,0.719149749,15603.55318,109.44682,109.44682,0.696536753
57,24-03-2022,15713,3,3,15600,113,113,0.719149749,15721.88679,-8.88679,8.88679,0.056556927
58,24-03-2022,15603,3,3,15600,3,3,0.019227072,15666.36115,-63.36115,63.36115,0.406083125
59,24-03-2022,15776,3,3,15600,176,176,1.115618661,15475.12853,300.87147,300.87147,1.907146742
60,24-03-2022,15806,3,3,15600,206,206,1.303302543,15308.44053,497.55947,497.55947,3.147915159
61,24-03-2022,15673,3,3,15600,73,73,0.465769157,15283.31776,389.68224,389.68224,2.486328335
62,24-03-2022,15702,3,3,15600,102,102,0.649598777,15384.85304,317.14696,317.14696,2.019787033
63,24-03-2022,15462,3,3,15600,-138,138,0.892510671,15307.69389,154.30611,154.30611,0.997969926
64,24-03-2022,15530,3,3,15600,-70,70,0.450740502,15356.34194,173.65806,173.65806,1.118210303
65,24-03-2022,15437,3,3,15640,-203,203,1.315022349,15359.85396,77.14604,77.14604,0.499747619
66,24-03-2022,15467,3,3,15700,-233,233,1.506433051,15492.90552,-25.90552,25.90552,0.167488977
67,24-03-2022,15662,3,3,15760,-98,98,0.625718299,15605.68289,56.31711,56.31711,0.359578023
68,24-03-2022,15766,3,3,15800,-34,34,0.215653939,15621.34745,144.65255,144.65255,0.917496829
69,24-03-2022,15693,3,3,15840,-147,147,0.93672338,15669.78661,23.21339,23.21339,0.14792194
70,24-03-2022,15575,3,3,15900,-325,325,2.086677368,15775.37038,-200.37038,200.37038,1.286487191
71,24-03-2022,15448,3,3,15960,-512,512,3.314344899,15779.82153,-331.82153,331.82153,2.147990225
72,24-03-2022,15337,3,3,16000,-663,663,4.322879311,15736.09461,-399.09461,399.09461,2.602168677
73,24-03-2022,15422,3,3,16000,-578,578,3.747892621,15728.35564,-306.35564,306.35564,1.986484503
74,24-03-2022,15551,3,3,16200,-649,649,4.173365057,16006.26232,-455.26232,455.26232,2.927543695
75,24-03-2022,15791,3,3,16400,-609,609,3.856627193,16095.49428,-304.49428,304.49428,1.928277373
76,24-03-2022,15936,3,3,16500,-564,564,3.539156627,15940.06669,-4.06669,4.06669,0.025518888
77,24-03-2022,15950,3,3,16300,-350,350,2.194357367,15781.92908,168.07092,168.07092,1.053736176
78,24-03-2022,15850,3,3,16100,-250,250,1.577287066,15626.16428,223.83572,223.83572,1.412212744
79,24-03-2022,15799,3,3,16060,-261,261,1.652003291,15535.97683,263.02317,263.02317,1.664808975
80,24-03-2022,15694,3,3,15990,-296,296,1.88607111,15453.63135,240.36865,240.36865,1.531595833
81,24-03-2022,15620,3,3,15890,-270,270,1.728553137,15033.42517,586.57483,586.57483,3.755280602
82,24-03-2022,15616,3,3,16050,-434,434,2.77920082,15016.21256,599.78744,599.78744,3.840851947
83,24-03-2022,15605,3,3,16020,-415,415,2.659404037,15360.82556,244.17444,244.17444,1.564719257
84,24-03-2022,15668,3,3,16000,-332,332,2.118968598,14925.82999,742.17001,742.17001,4.736852247
85,24-03-2022,15692,3,3,15980,-288,288,1.835330105,14885.23728,806.76272,806.76272,5.141235789
86,24-03-2022,15706,3,3,15950,-244,244,1.553546415,14786.32182,919.67818,919.67818,5.855584999
87,24-03-2022,15875,3,3,15920,-45,45,0.283464567,14703.28028,1171.71972,1171.71972,7.380911622
88,24-03-2022,15909,3,3,15900,9,9,0.056571752,14561.65366,1347.34634,1347.34634,8.469082532
89,24-03-2022,15785,3,3,15840,-55,55,0.348432056,14341.36698,1443.63302,1443.63302,9.14560038
90,24-03-2022,15784,3,3,15750,34,34,0.215408008,14313.99265,1470.00735,1470.00735,9.313275152
91,24-03-2022,15525,3,3,15660,-135,135,0.869565217,14174.30794,1350.69206,1350.69206,8.700109887
92,24-03-2022,15142,3,3,15600,-458,458,3.024699511,13943.01952,1198.98048,1198.98048,7.918243825
93,24-03-2022,14922,3,3,15420,-498,498,3.337354242,13835.6518,1086.3482,1086.3482,7.28017826
94,24-03-2022,14695,3,3,15150,-455,455,3.096291256,13760.86995,934.13005,934.13005,6.356788363
95,24-03-2022,14522,3,3,14880,-358,358,2.465225176,13757.27927,764.72073,764.72073,5.265946357
96,24-03-2022,14330,3,3,14700,-370,370,2.581995813,13633.45364,696.54636,696.54636,4.860756176
1,25-03-2022,14169,4,3,13920,249,249,1.757357612,14069.49787,99.50213,99.50213,0.702252311
2,25-03-2022,14070,4,3,13880,190,190,1.350390903,13940.75349,129.24651,129.24651,0.918596375
3,25-03-2022,13906,4,3,13840,66,66,0.474615274,13893.22186,12.77814,12.77814,0.0918894
4,25-03-2022,13829,4,3,13800,29,29,0.209704245,13834.78253,-5.78253,5.78253,0.04181452
5,25-03-2022,13662,4,3,13760,-98,98,0.717318109,13694.77641,-32.77641,32.77641,0.23990931
6,25-03-2022,13638,4,3,13700,-62,62,0.454612113,13649.58022,-11.58022,11.58022,0.084911424
7,25-03-2022,13586,4,3,13640,-54,54,0.397467982,13621.58256,-35.58256,35.58256,0.26190608
8,25-03-2022,13703,4,3,13600,103,103,0.75166022,13590.59746,112.40254,112.40254,0.820276874
9,25-03-2022,13627,4,3,13560,67,67,0.491670947,13518.20993,108.79007,108.79007,0.798342042
10,25-03-2022,13618,4,3,13500,118,118,0.86650022,13459.68638,158.31362,158.31362,1.16253209
11,25-03-2022,13566,4,3,13440,126,126,0.92879257,13560.18669,5.81331,5.81331,0.042852057
12,25-03-2022,13473,4,3,13400,73,73,0.54182439,13460.90756,12.09244,12.09244,0.089753136
13,25-03-2022,13413,4,3,13360,53,53,0.395139044,13478.39412,-65.39412,65.39412,0.487542832
14,25-03-2022,13454,4,3,13320,134,134,0.995986324,13374.50388,79.49612,79.49612,0.590873495
15,25-03-2022,13456,4,3,13280,176,176,1.307966706,13271.12417,184.87583,184.87583,1.373928582
16,25-03-2022,13390,4,3,13200,190,190,1.41896938,13213.3025,176.6975,176.6975,1.319622853
17,25-03-2022,13366,4,3,13170,196,196,1.466407302,13277.70674,88.29326,88.29326,0.660581026
18,25-03-2022,13287,4,3,13160,127,127,0.95582148,13356.15171,-69.15171,69.15171,0.520446376
19,25-03-2022,13414,4,3,13120,294,294,2.191739973,13294.96227,119.03773,119.03773,0.88741412
20,25-03-2022,13366,4,3,13100,266,266,1.990124196,13332.00007,33.99993,33.99993,0.254376253
21,25-03-2022,13368,4,3,13200,168,168,1.256732496,13353.56703,14.43297,14.43297,0.107966562
22,25-03-2022,13403,4,3,13350,53,53,0.395433858,13521.89036,-118.89036,118.89036,0.887042901
23,25-03-2022,13555,4,3,13500,55,55,0.405754334,13689.97505,-134.97505,134.97505,0.995758392
24,25-03-2022,13721,4,3,13600,121,121,0.881859923,13862.86303,-141.86303,141.86303,1.033911741
25,25-03-2022,13995,4,3,13900,95,95,0.678813862,14067.24207,-72.24207,72.24207,0.516199143
26,25-03-2022,14516,4,3,14350,166,166,1.143565721,14568.56539,-52.56539,52.56539,0.36212035
27,25-03-2022,14870,4,3,14800,70,70,0.470746469,15019.60192,-149.60192,149.60192,1.006065367
28,25-03-2022,15071,4,3,15100,-29,29,0.192422533,15433.86179,-362.86179,362.86179,2.407682237
29,25-03-2022,15461,4,3,15250,211,211,1.364724145,15676.99219,-215.99219,215.99219,1.397013065
30,25-03-2022,15857,4,3,15325,532,532,3.35498518,15868.90837,-11.90837,11.90837,0.075098505
31,25-03-2022,15846,4,3,15400,446,446,2.814590433,15917.78383,-71.78383,71.78383,0.453009151
32,25-03-2022,15769,4,3,15800,-31,31,0.196588243,15762.03785,6.96215,6.96215,0.044150866
33,25-03-2022,14926,4,3,15720,-794,794,5.319576578,15620.48561,-694.48561,694.48561,4.652858167
34,25-03-2022,14991,4,3,15600,-609,609,4.062437462,15495.71853,-504.71853,504.71853,3.366810286
35,25-03-2022,15423,4,3,15480,-57,57,0.369577903,15542.42919,-119.42919,119.42919,0.774357713
36,25-03-2022,15555,4,3,15400,155,155,0.996464159,15439.29997,115.70003,115.70003,0.743812472
37,25-03-2022,15422,4,3,15540,-118,118,0.765140708,15384.24854,37.75146,37.75146,0.244789651
38,25-03-2022,15820,4,3,15750,70,70,0.442477876,15658.31073,161.68927,161.68927,1.022056068
39,25-03-2022,15961,4,3,15960,1,1,0.006265272,15980.55102,-19.55102,19.55102,0.12249245
40,25-03-2022,16153,4,3,16100,53,53,0.328112425,16257.0344,-104.0344,104.0344,0.644056212
41,25-03-2022,16155,4,3,16140,15,15,0.092850511,16364.26455,-209.26455,209.26455,1.295354689
42,25-03-2022,16140,4,3,16200,-60,60,0.371747212,16400.96953,-260.96953,260.96953,1.616911586
43,25-03-2022,16024,4,3,16140,-116,116,0.723914129,16488.38304,-464.38304,464.38304,2.89804693
44,25-03-2022,16044,4,3,16300,-256,256,1.595612067,16669.61967,-625.61967,625.61967,3.899399589
45,25-03-2022,16011,4,3,16260,-249,249,1.555180813,16539.56216,-528.56216,528.56216,3.301243895
46,25-03-2022,16192,4,3,16200,-8,8,0.049407115,16591.34281,-399.34281,399.34281,2.466296999
47,25-03-2022,16120,4,3,16140,-20,20,0.124069479,16462.98316,-342.98316,342.98316,2.127687097
48,25-03-2022,16092,4,3,16100,-8,8,0.049714144,16481.21171,-389.21171,389.21171,2.418665859
49,25-03-2022,15677,4,3,16080,-403,403,2.570644894,16312.36945,-635.36945,635.36945,4.052876507
50,25-03-2022,16002,4,3,16050,-48,48,0.299962505,16398.28583,-396.28583,396.28583,2.476476878
51,25-03-2022,15808,4,3,16020,-212,212,1.341093117,16356.64405,-548.64405,548.64405,3.470673393
52,25-03-2022,15802,4,3,16000,-198,198,1.253005949,16136.21125,-334.21125,334.21125,2.114993355
53,25-03-2022,15726,4,3,15850,-124,124,0.788503116,15877.00833,-151.00833,151.00833,0.96024628
54,25-03-2022,15418,4,3,15790,-372,372,2.412764301,15876.55683,-458.55683,458.55683,2.974165456
55,25-03-2022,15507,4,3,15760,-253,253,1.631521248,15913.67507,-406.67507,406.67507,2.622525763
56,25-03-2022,15639,4,3,15700,-61,61,0.390050515,15845.24721,-206.24721,206.24721,1.318800499
57,25-03-2022,15677,4,3,15710,-33,33,0.210499458,15771.06581,-94.06581,94.06581,0.600024303
58,25-03-2022,16020,4,3,15750,270,270,1.685393258,15776.32557,243.67443,243.67443,1.521063858
59,25-03-2022,15796,4,3,15780,16,16,0.101291466,15780.15027,15.84973,15.84973,0.100340149
60,25-03-2022,15520,4,3,15800,-280,280,1.804123711,15670.26341,-150.26341,150.26341,0.968192075
61,25-03-2022,15486,4,3,15740,-254,254,1.64019114,15571.81106,-85.81106,85.81106,0.554120238
62,25-03-2022,15584,4,3,15650,-66,66,0.423511294,15576.22209,7.77791,7.77791,0.049909587
63,25-03-2022,15241,4,3,15560,-319,319,2.093038515,15359.50292,-118.50292,118.50292,0.777527196
64,25-03-2022,15500,4,3,15500,0,0,0,15372.23503,127.76497,127.76497,0.824290129
65,25-03-2022,15287,4,3,15540,-253,253,1.655000981,15261.51581,25.48419,25.48419,0.166704978
66,25-03-2022,15372,4,3,15600,-228,228,1.483216237,15280.3184,91.6816,91.6816,0.596419464
67,25-03-2022,15508,4,3,15660,-152,152,0.980139283,15307.16225,200.83775,200.83775,1.295059002
68,25-03-2022,15878,4,3,15700,178,178,1.121047991,15440.09852,437.90148,437.90148,2.757913339
69,25-03-2022,15939,4,3,15760,179,179,1.123031558,15310.95516,628.04484,628.04484,3.940302654
70,25-03-2022,15862,4,3,15850,12,12,0.075652503,15345.65277,516.34723,516.34723,3.25524669
71,25-03-2022,15887,4,3,15940,-53,53,0.333606093,15390.51521,496.48479,496.48479,3.125100963
72,25-03-2022,15870,4,3,16000,-130,130,0.81915564,15392.33285,477.66715,477.66715,3.009874921
73,25-03-2022,15764,4,3,16000,-236,236,1.497081959,15335.76228,428.23772,428.23772,2.716554935
74,25-03-2022,16092,4,3,16200,-108,108,0.67114094,15485.61239,606.38761,606.38761,3.768255096
75,25-03-2022,16234,4,3,16400,-166,166,1.022545275,15644.39841,589.60159,589.60159,3.631893495
76,25-03-2022,16188,4,3,16500,-312,312,1.927353595,15582.46437,605.53563,605.53563,3.740645107
77,25-03-2022,16082,4,3,16300,-218,218,1.355552792,15458.37518,623.62482,623.62482,3.877781495
78,25-03-2022,16054,4,3,16100,-46,46,0.286532951,15341.7749,712.2251,712.2251,4.436433911
79,25-03-2022,15908,4,3,16060,-152,152,0.955494091,15362.96531,545.03469,545.03469,3.426167274
80,25-03-2022,15546,4,3,15970,-424,424,2.727389682,15229.32475,316.67525,316.67525,2.037020777
81,25-03-2022,15444,4,3,15870,-426,426,2.758352758,15072.63184,371.36816,371.36816,2.404611241
82,25-03-2022,15379,4,3,15950,-571,571,3.712855192,15095.19716,283.80284,283.80284,1.845392028
83,25-03-2022,15310,4,3,15860,-550,550,3.592423253,15120.9375,189.0625,189.0625,1.234895493
84,25-03-2022,15257,4,3,15800,-543,543,3.559022088,15202.97772,54.02228,54.02228,0.35408193
85,25-03-2022,15482,4,3,15840,-358,358,2.312362744,15247.14764,234.85236,234.85236,1.516938122
86,25-03-2022,15531,4,3,15900,-369,369,2.375893375,15239.25697,291.74303,291.74303,1.878456184
87,25-03-2022,15486,4,3,15960,-474,474,3.060829136,15255.68951,230.31049,230.31049,1.487217422
88,25-03-2022,15523,4,3,16000,-477,477,3.072859628,15260.8534,262.1466,262.1466,1.688762481
89,25-03-2022,15471,4,3,15880,-409,409,2.643655872,15141.888,329.112,329.112,2.127283304
90,25-03-2022,15423,4,3,15700,-277,277,1.796018933,15116.96213,306.03787,306.03787,1.984295338
91,25-03-2022,15079,4,3,15520,-441,441,2.924597122,14948.09802,130.90198,130.90198,0.868107832
92,25-03-2022,14867,4,3,15400,-533,533,3.58512141,14679.4362,187.5638,187.5638,1.261611623
93,25-03-2022,14898,4,3,15280,-382,382,2.564102564,14536.86255,361.13745,361.13745,2.424066653
94,25-03-2022,14642,4,3,15100,-458,458,3.12798798,14383.35007,258.64993,258.64993,1.76649317
95,25-03-2022,14484,4,3,14920,-436,436,3.010218172,14172.07692,311.92308,311.92308,2.153570008
96,25-03-2022,14311,4,3,14800,-489,489,3.416951995,13998.91552,312.08448,312.08448,2.180731465
1,26-03-2022,14165,5,3,14060,105,105,0.741263678,14128.88722,36.11278,36.11278,0.254943735
2,26-03-2022,13890,5,3,14040,-150,150,1.079913607,14018.21812,-128.21812,128.21812,0.923096616
3,26-03-2022,13023,5,3,14020,-997,997,7.655686094,13898.27957,-875.27957,875.27957,6.721028718
4,26-03-2022,13870,5,3,14000,-130,130,0.937274694,13829.59705,40.40295,40.40295,0.291297404
5,26-03-2022,13816,5,3,13980,-164,164,1.187029531,13664.10614,151.89386,151.89386,1.099405472
6,26-03-2022,13847,5,3,13950,-103,103,0.743843432,13656.24096,190.75904,190.75904,1.37761999
7,26-03-2022,13749,5,3,13920,-171,171,1.243726816,13611.82945,137.17055,137.17055,0.997676558
8,26-03-2022,13737,5,3,13900,-163,163,1.1865764,13672.14604,64.85396,64.85396,0.472111524
9,26-03-2022,13678,5,3,13840,-162,162,1.184383682,13613.6851,64.3149,64.3149,0.470206902
10,26-03-2022,13687,5,3,13750,-63,63,0.460290787,13586.40691,100.59309,100.59309,0.734953533
11,26-03-2022,13659,5,3,13660,-1,1,0.00732118,13584.68306,74.31694,74.31694,0.544087708
12,26-03-2022,13750,5,3,13600,150,150,1.090909091,13516.40295,233.59705,233.59705,1.698887636
13,26-03-2022,13613,5,3,13580,33,33,0.242415338,13479.0154,133.9846,133.9846,0.984240065
14,26-03-2022,13655,5,3,13560,95,95,0.695715855,13464.39226,190.60774,190.60774,1.395882387
15,26-03-2022,13537,5,3,13540,-3,3,0.022161483,13446.04484,90.95516,90.95516,0.671900421
16,26-03-2022,13467,5,3,13500,-33,33,0.24504344,13414.36111,52.63889,52.63889,0.390873171
17,26-03-2022,13368,5,3,13500,-132,132,0.987432675,13391.3259,-23.3259,23.3259,0.174490575
18,26-03-2022,13310,5,3,13500,-190,190,1.427498122,13363.15059,-53.15059,53.15059,0.399328249
19,26-03-2022,13341,5,3,13500,-159,159,1.191814707,13412.2743,-71.2743,71.2743,0.534250056
20,26-03-2022,13269,5,3,13500,-231,231,1.740899842,13395.08523,-126.08523,126.08523,0.950224056
21,26-03-2022,13270,5,3,13560,-290,290,2.185380558,13397.26845,-127.26845,127.26845,0.959068953
22,26-03-2022,13400,5,3,13650,-250,250,1.865671642,13457.61271,-57.61271,57.61271,0.429945597
23,26-03-2022,13548,5,3,13740,-192,192,1.417183348,13637.77697,-89.77697,89.77697,0.662658474
24,26-03-2022,13756,5,3,13800,-44,44,0.319860425,13767.10768,-11.10768,11.10768,0.080747892
25,26-03-2022,13947,5,3,14060,-113,113,0.810210081,14031.95535,-84.95535,84.95535,0.60912992
26,26-03-2022,14373,5,3,14450,-77,77,0.53572671,14580.5296,-207.5296,207.5296,1.443885062
27,26-03-2022,14722,5,3,14840,-118,118,0.801521532,14974.66007,-252.66007,252.66007,1.716207513
28,26-03-2022,15105,5,3,15100,5,5,0.033101622,15220.54275,-115.54275,115.54275,0.764930487
29,26-03-2022,15394,5,3,15230,164,164,1.065350136,15600.52557,-206.52557,206.52557,1.34159783
30,26-03-2022,15432,5,3,15295,137,137,0.887765682,15918.13107,-486.13107,486.13107,3.150149495
31,26-03-2022,15534,5,3,15360,174,174,1.1201236,15929.18056,-395.18056,395.18056,2.543971675
32,26-03-2022,15543,5,3,15800,-257,257,1.65347745,15796.99709,-253.99709,253.99709,1.634157434
33,26-03-2022,15503,5,3,15760,-257,257,1.657743663,15218.37679,284.62321,284.62321,1.835923434
34,26-03-2022,15429,5,3,15700,-271,271,1.756432692,15193.51495,235.48505,235.48505,1.526249595
35,26-03-2022,15499,5,3,15640,-141,141,0.909736112,15472.2053,26.7947,26.7947,0.172880186
36,26-03-2022,15640,5,3,15600,40,40,0.255754476,15490.1631,149.8369,149.8369,0.958036445
37,26-03-2022,15633,5,3,15700,-67,67,0.428580567,15461.96938,171.03062,171.03062,1.094035822
38,26-03-2022,15980,5,3,15850,130,130,0.813516896,15802.76204,177.23796,177.23796,1.109123655
39,26-03-2022,16058,5,3,16000,58,58,0.361190684,15970.61274,87.38726,87.38726,0.544197658
40,26-03-2022,16320,5,3,16100,220,220,1.348039216,16191.63507,128.36493,128.36493,0.786549816
41,26-03-2022,16527,5,3,16160,367,367,2.220608701,16203.13675,323.86325,323.86325,1.959600956
42,26-03-2022,16260,5,3,16300,-40,40,0.24600246,16233.69179,26.30821,26.30821,0.161797109
43,26-03-2022,16345,5,3,16240,105,105,0.642398287,16180.61613,164.38387,164.38387,1.00571349
44,26-03-2022,16574,5,3,16400,174,174,1.049837094,16237.25721,336.74279,336.74279,2.031753288
45,26-03-2022,16564,5,3,16360,204,204,1.231586573,16200.93627,363.06373,363.06373,2.191884388
46,26-03-2022,16593,5,3,16300,293,293,1.765804857,16309.47323,283.52677,283.52677,1.708713132
47,26-03-2022,16686,5,3,16240,446,446,2.672899437,16252.10935,433.89065,433.89065,2.60032752
48,26-03-2022,16427,5,3,16200,227,227,1.381871309,16223.77314,203.22686,203.22686,1.237151397
49,26-03-2022,16384,5,3,16140,244,244,1.489257813,15950.32915,433.67085,433.67085,2.646916809
50,26-03-2022,16497,5,3,16050,447,447,2.709583561,16136.2295,360.7705,360.7705,2.186885494
51,26-03-2022,16458,5,3,15960,498,498,3.025884069,16056.3339,401.6661,401.6661,2.440552315
52,26-03-2022,16374,5,3,15900,474,474,2.894833272,15919.07907,454.92093,454.92093,2.778312752
53,26-03-2022,16127,5,3,15800,327,327,2.027655485,15822.9742,304.0258,304.0258,1.885197495
54,26-03-2022,16253,5,3,15760,493,493,3.033286163,15602.65026,650.34974,650.34974,4.001413524
55,26-03-2022,16204,5,3,15740,464,464,2.863490496,15684.39765,519.60235,519.60235,3.206630153
56,26-03-2022,16405,5,3,15700,705,705,4.297470283,15731.11997,673.88003,673.88003,4.107772204
57,26-03-2022,16436,5,3,15700,736,736,4.477975176,15751.81965,684.18035,684.18035,4.162693782
58,26-03-2022,16399,5,3,15700,699,699,4.262455028,15962.57071,436.42929,436.42929,2.661316483
59,26-03-2022,16335,5,3,15700,635,635,3.887358433,15882.76098,452.23902,452.23902,2.768527824
60,26-03-2022,16450,5,3,15700,750,750,4.559270517,15702.20195,747.79805,747.79805,4.545884802
61,26-03-2022,16173,5,3,15680,493,493,3.04829036,15598.70803,574.29197,574.29197,3.550930378
62,26-03-2022,15839,5,3,15650,189,189,1.19325715,15700.05942,138.94058,138.94058,0.877205505
63,26-03-2022,15883,5,3,15620,263,263,1.655858465,15389.19723,493.80277,493.80277,3.109001889
64,26-03-2022,15968,5,3,15600,368,368,2.304609218,15564.73752,403.26248,403.26248,2.525441383
65,26-03-2022,15812,5,3,15560,252,252,1.593726284,15364.34021,447.65979,447.65979,2.831139578
66,26-03-2022,15824,5,3,15500,324,324,2.04752275,15455.48731,368.51269,368.51269,2.328821347
67,26-03-2022,15779,5,3,15440,339,339,2.148425122,15583.90279,195.09721,195.09721,1.236435832
68,26-03-2022,16005,5,3,15400,605,605,3.780068729,15851.59107,153.40893,153.40893,0.958506279
69,26-03-2022,15716,5,3,15460,256,256,1.628913209,15863.11663,-147.11663,147.11663,0.936094617
70,26-03-2022,15783,5,3,15550,233,233,1.476271938,15794.3202,-11.3202,11.3202,0.071724007
71,26-03-2022,15670,5,3,15640,30,30,0.191448628,15790.05766,-120.05766,120.05766,0.766162476
72,26-03-2022,15448,5,3,15700,-252,252,1.63127913,15779.55258,-331.55258,331.55258,2.146249223
73,26-03-2022,15481,5,3,15800,-319,319,2.060590401,15736.51028,-255.51028,255.51028,1.650476584
74,26-03-2022,15647,5,3,16000,-353,353,2.256023519,16012.36958,-365.36958,365.36958,2.335077523
75,26-03-2022,15809,5,3,16200,-391,391,2.473274717,16149.80082,-340.80082,340.80082,2.155739262
76,26-03-2022,15814,5,3,16300,-486,486,3.073226255,16135.15331,-321.15331,321.15331,2.030816428
77,26-03-2022,15784,5,3,16100,-316,316,2.002027369,16051.99284,-267.99284,267.99284,1.697876584
78,26-03-2022,15874,5,3,15900,-26,26,0.163789845,15992.44955,-118.44955,118.44955,0.746185901
79,26-03-2022,15813,5,3,15750,63,63,0.398406375,15866.13511,-53.13511,53.13511,0.336021691
80,26-03-2022,15726,5,3,15690,36,36,0.228920259,15591.23986,134.76014,134.76014,0.856925728
81,26-03-2022,15617,5,3,15590,27,27,0.172888519,15486.37342,130.62658,130.62658,0.836438368
82,26-03-2022,15607,5,3,15750,-143,143,0.916255526,15446.84274,160.15726,160.15726,1.026188633
83,26-03-2022,15522,5,3,15720,-198,198,1.275608813,15433.23894,88.76106,88.76106,0.571840356
84,26-03-2022,15462,5,3,15700,-238,238,1.539257535,15420.85667,41.14333,41.14333,0.266093196
85,26-03-2022,15477,5,3,15740,-263,263,1.699295729,15560.2223,-83.2223,83.2223,0.537715966
86,26-03-2022,15617,5,3,15800,-183,183,1.171799962,15637.70023,-20.70023,20.70023,0.132549337
87,26-03-2022,15610,5,3,15860,-250,250,1.601537476,15597.7203,12.2797,12.2797,0.078665599
88,26-03-2022,15575,5,3,15900,-325,325,2.086677368,15570.14406,4.85594,4.85594,0.031177785
89,26-03-2022,15490,5,3,15740,-250,250,1.61394448,15503.60978,-13.60978,13.60978,0.087861717
90,26-03-2022,15557,5,3,15500,57,57,0.366394549,15468.82683,88.17317,88.17317,0.566774892
91,26-03-2022,15490,5,3,15260,230,230,1.484828922,15232.28514,257.71486,257.71486,1.663749903
92,26-03-2022,15339,5,3,15100,239,239,1.558119825,15003.96526,335.03474,335.03474,2.184201969
93,26-03-2022,15114,5,3,14960,154,154,1.018922853,14964.56399,149.43601,149.43601,0.988725751
94,26-03-2022,14833,5,3,14750,83,83,0.559563136,14727.99601,105.00399,105.00399,0.707907975
95,26-03-2022,14704,5,3,14540,164,164,1.115342764,14606.37675,97.62325,97.62325,0.663923082
96,26-03-2022,14573,5,3,14400,173,173,1.187126878,14348.52878,224.47122,224.47122,1.540322651
1,27-03-2022,14482,6,3,14120,362,362,2.499654744,14068.69076,413.30924,413.30924,2.853951388
2,27-03-2022,14281,6,3,14080,201,201,1.407464463,13921.87901,359.12099,359.12099,2.514676773
3,27-03-2022,14238,6,3,14040,198,198,1.390644753,13561.46388,676.53612,676.53612,4.751623262
4,27-03-2022,14215,6,3,14000,215,215,1.51248681,13773.43289,441.56711,441.56711,3.106346184
5,27-03-2022,14113,6,3,13960,153,153,1.084106852,13625.57234,487.42766,487.42766,3.453749451
6,27-03-2022,14004,6,3,13900,104,104,0.742644959,13657.90917,346.09083,346.09083,2.471371251
7,27-03-2022,12901,6,3,13840,-939,939,7.278505542,13607.58211,-706.58211,706.58211,5.476956127
8,27-03-2022,13820,6,3,13800,20,20,0.1447178,13642.00392,177.99608,177.99608,1.287960058
9,27-03-2022,13773,6,3,13760,13,13,0.09438757,13597.80236,175.19764,175.19764,1.272036884
10,27-03-2022,13742,6,3,13700,42,42,0.305632368,13559.67512,182.32488,182.32488,1.326771067
11,27-03-2022,13623,6,3,13640,-17,17,0.12478896,13564.76825,58.23175,58.23175,0.427451736
12,27-03-2022,13600,6,3,13600,0,0,0,13560.90739,39.09261,39.09261,0.287445662
13,27-03-2022,13440,6,3,13560,-120,120,0.892857143,13466.31498,-26.31498,26.31498,0.195795982
14,27-03-2022,13345,6,3,13520,-175,175,1.311352567,13467.09167,-122.09167,122.09167,0.914886999
15,27-03-2022,13189,6,3,13480,-291,291,2.206384108,13383.27066,-194.27066,194.27066,1.472974903
16,27-03-2022,13184,6,3,13400,-216,216,1.638349515,13345.70341,-161.70341,161.70341,1.226512515
17,27-03-2022,13193,6,3,13340,-147,147,1.114227242,13291.84855,-98.84855,98.84855,0.749249981
18,27-03-2022,13193,6,3,13320,-127,127,0.962631699,13210.92026,-17.92026,17.92026,0.135831577
19,27-03-2022,13207,6,3,13240,-33,33,0.249867495,13247.41538,-40.41538,40.41538,0.306014841
20,27-03-2022,13245,6,3,13200,45,45,0.339750849,13229.18932,15.81068,15.81068,0.119370932
21,27-03-2022,13285,6,3,13240,45,45,0.338727889,13214.945,70.055,70.055,0.52732405
22,27-03-2022,13352,6,3,13300,52,52,0.389454763,13261.10775,90.89225,90.89225,0.680738841
23,27-03-2022,13385,6,3,13360,25,25,0.186776242,13414.62463,-29.62463,29.62463,0.221327083
24,27-03-2022,13364,6,3,13400,-36,36,0.269380425,13507.35446,-143.35446,143.35446,1.07269126
25,27-03-2022,13507,6,3,13460,47,47,0.34796772,13679.77054,-172.77054,172.77054,1.279118531
26,27-03-2022,13793,6,3,13550,243,243,1.761763213,14090.77024,-297.77024,297.77024,2.158850431
27,27-03-2022,13998,6,3,13640,358,358,2.557508215,14426.35056,-428.35056,428.35056,3.060084012
28,27-03-2022,14118,6,3,13700,418,418,2.960759314,14664.73863,-546.73863,546.73863,3.872635147
29,27-03-2022,14227,6,3,13730,497,497,3.4933577,14917.59466,-690.59466,690.59466,4.854113025
30,27-03-2022,14284,6,3,13745,539,539,3.773452814,15099.1215,-815.1215,815.1215,5.706535284
31,27-03-2022,14465,6,3,13760,705,705,4.873833391,15175.35298,-710.35298,710.35298,4.91083982
32,27-03-2022,14404,6,3,14100,304,304,2.110524854,15125.46021,-721.46021,721.46021,5.008749028
33,27-03-2022,14466,6,3,14060,406,406,2.806580948,14787.95728,-321.95728,321.95728,2.225613715
34,27-03-2022,14458,6,3,14000,458,458,3.167796376,14760.63172,-302.63172,302.63172,2.09317831
35,27-03-2022,14486,6,3,13940,546,546,3.769156427,14940.78886,-454.78886,454.78886,3.139506144
36,27-03-2022,14627,6,3,13900,727,727,4.970260477,15051.77218,-424.77218,424.77218,2.90402803
37,27-03-2022,14641,6,3,13960,681,681,4.651321631,15029.72381,-388.72381,388.72381,2.655035927
38,27-03-2022,14843,6,3,14050,793,793,5.342585731,15359.73194,-516.73194,516.73194,3.481317389
39,27-03-2022,14995,6,3,14140,855,855,5.701900634,15508.7003,-513.7003,513.7003,3.425810604
40,27-03-2022,15114,6,3,14200,914,914,6.047373296,15689.51041,-575.51041,575.51041,3.807796811
41,27-03-2022,15280,6,3,14260,1020,1020,6.67539267,15744.38856,-464.38856,464.38856,3.039192147
42,27-03-2022,15234,6,3,14400,834,834,5.474596298,15759.14507,-525.14507,525.14507,3.447190954
43,27-03-2022,15165,6,3,14340,825,825,5.440158259,15746.9863,-581.9863,581.9863,3.837694032
44,27-03-2022,15220,6,3,14500,720,720,4.730617608,15872.11535,-652.11535,652.11535,4.284594941
45,27-03-2022,15165,6,3,14460,705,705,4.648862512,15871.90444,-706.90444,706.90444,4.66142064
46,27-03-2022,15092,6,3,14400,692,692,4.585210708,16001.24359,-909.24359,909.24359,6.024672608
47,27-03-2022,15223,6,3,14340,883,883,5.800433554,15946.98565,-723.98565,723.98565,4.755867109
48,27-03-2022,14993,6,3,14300,693,693,4.622157007,15834.55492,-841.55492,841.55492,5.612985527
49,27-03-2022,14931,6,3,14260,671,671,4.49400576,15680.95104,-749.95104,749.95104,5.022778381
50,27-03-2022,15040,6,3,14200,840,840,5.585106383,15850.04569,-810.04569,810.04569,5.385942088
51,27-03-2022,15241,6,3,14140,1101,1101,7.223935437,15752.14411,-511.14411,511.14411,3.353743914
52,27-03-2022,14953,6,3,14100,853,853,5.704540895,15563.78849,-610.78849,610.78849,4.084722062
53,27-03-2022,14736,6,3,13950,786,786,5.333876221,15519.64431,-783.64431,783.64431,5.317890269
54,27-03-2022,14963,6,3,13890,1073,1073,7.171021854,15468.08137,-505.08137,505.08137,3.375535454
55,27-03-2022,15090,6,3,13860,1230,1230,8.151093439,15456.20404,-366.20404,366.20404,2.42679947
56,27-03-2022,15075,6,3,13800,1275,1275,8.457711443,15521.88633,-446.88633,446.88633,2.9644201
57,27-03-2022,14974,6,3,13780,1194,1194,7.97382129,15429.25075,-455.25075,455.25075,3.04027481
58,27-03-2022,14892,6,3,13700,1192,1192,8.004297609,15469.69355,-577.69355,577.69355,3.879220723
59,27-03-2022,14698,6,3,13640,1058,1058,7.198258266,15437.60177,-739.60177,739.60177,5.031989182
60,27-03-2022,14643,6,3,13600,1043,1043,7.122857338,15377.05118,-734.05118,734.05118,5.012983542
61,27-03-2022,14545,6,3,13520,1025,1025,7.047095222,15179.55383,-634.55383,634.55383,4.362693915
62,27-03-2022,14174,6,3,13400,774,774,5.460702695,15182.30701,-1008.30701,1008.30701,7.11377882
63,27-03-2022,14256,6,3,13280,976,976,6.84624018,14970.16606,-714.16606,714.16606,5.009582351
64,27-03-2022,14198,6,3,13200,998,998,7.029159036,15072.68517,-874.68517,874.68517,6.160622412
65,27-03-2022,14222,6,3,13180,1042,1042,7.326676979,14912.49073,-690.49073,690.49073,4.855088806
66,27-03-2022,14259,6,3,13150,1109,1109,7.777544007,14903.1308,-644.1308,644.1308,4.517363069
67,27-03-2022,14299,6,3,13120,1179,1179,8.245331841,14963.1598,-664.1598,664.1598,4.644798937
68,27-03-2022,14242,6,3,13100,1142,1142,8.018536722,15157.34284,-915.34284,915.34284,6.427066704
69,27-03-2022,14183,6,3,13140,1043,1043,7.353874357,15068.8282,-885.8282,885.8282,6.245704012
70,27-03-2022,14274,6,3,13200,1074,1074,7.524169819,15024.96862,-750.96862,750.96862,5.261094437
71,27-03-2022,14162,6,3,13260,902,902,6.369156899,14939.48526,-777.48526,777.48526,5.489939698
72,27-03-2022,14217,6,3,13300,917,917,6.450024618,14833.89993,-616.89993,616.89993,4.339170922
73,27-03-2022,14086,6,3,13300,786,786,5.580008519,14855.3254,-769.3254,769.3254,5.461631407
74,27-03-2022,14174,6,3,13500,674,674,4.755185551,15039.85447,-865.85447,865.85447,6.108751729
75,27-03-2022,14308,6,3,13700,608,608,4.249370981,15229.48467,-921.48467,921.48467,6.440345751
76,27-03-2022,14280,6,3,13800,480,480,3.361344538,15284.82238,-1004.82238,1004.82238,7.036571289
77,27-03-2022,14219,6,3,13600,619,619,4.353330051,15255.95356,-1036.95356,1036.95356,7.292731978
78,27-03-2022,14128,6,3,13400,728,728,5.152887882,15256.13351,-1128.13351,1128.13351,7.985089963
79,27-03-2022,14162,6,3,13470,692,692,4.886315492,15190.42753,-1028.42753,1028.42753,7.261880596
80,27-03-2022,14075,6,3,13370,705,705,5.008880995,15035.82842,-960.82842,960.82842,6.826489663
81,27-03-2022,13947,6,3,13270,677,677,4.854090485,14989.73815,-1042.73815,1042.73815,7.476433283
82,27-03-2022,13921,6,3,13350,571,571,4.101716831,14974.36262,-1053.36262,1053.36262,7.566716615
83,27-03-2022,13997,6,3,13260,737,737,5.265414017,14934.47953,-937.47953,937.47953,6.697717582
84,27-03-2022,14067,6,3,13200,867,867,6.163361058,14944.81391,-877.81391,877.81391,6.240235374
85,27-03-2022,14104,6,3,13240,864,864,6.125921724,15051.89681,-947.89681,947.89681,6.720765811
86,27-03-2022,14282,6,3,13300,982,982,6.875787705,15133.8234,-851.8234,851.8234,5.964314522
87,27-03-2022,14367,6,3,13360,1007,1007,7.009118118,15230.98209,-863.98209,863.98209,6.013656922
88,27-03-2022,14362,6,3,13400,962,962,6.698231444,15285.72197,-923.72197,923.72197,6.431708467
89,27-03-2022,14300,6,3,13340,960,960,6.713286713,15203.66675,-903.66675,903.66675,6.319347902
90,27-03-2022,14385,6,3,13250,1135,1135,7.890163365,15207.00836,-822.00836,822.00836,5.71434383
91,27-03-2022,14369,6,3,13160,1209,1209,8.413946691,15027.58945,-658.58945,658.58945,4.583404899
92,27-03-2022,14153,6,3,13100,1053,1053,7.440118703,14759.2206,-606.2206,606.2206,4.283336395
93,27-03-2022,14159,6,3,13040,1119,1119,7.903100501,14642.06693,-483.06693,483.06693,3.41173056
94,27-03-2022,13930,6,3,12950,980,980,7.035175879,14380.28119,-450.28119,450.28119,3.232456497
95,27-03-2022,13805,6,3,12860,945,945,6.845345889,14229.6198,-424.6198,424.6198,3.075840637
96,27-03-2022,13726,6,3,12800,926,926,6.746320851,14085.95744,-359.95744,359.95744,2.622449658
1,28-03-2022,13616,0,3,12960,656,656,4.81786134,13548.11359,67.88641,67.88641,0.498578217
2,28-03-2022,13559,0,3,12940,619,619,4.565233424,13349.49797,209.50203,209.50203,1.545114168
3,28-03-2022,13568,0,3,12920,648,648,4.775943396,13317.81867,250.18133,250.18133,1.843907208
4,28-03-2022,13506,0,3,12900,606,606,4.486894713,13280.89411,225.10589,225.10589,1.666710277
5,28-03-2022,13411,0,3,12880,531,531,3.959436284,13228.65554,182.34446,182.34446,1.359663411
6,28-03-2022,13420,0,3,12850,570,570,4.247391952,13096.23709,323.76291,323.76291,2.412540313
7,28-03-2022,13324,0,3,12820,504,504,3.782647853,12139.43765,1184.56235,1184.56235,8.890440934
8,28-03-2022,13356,0,3,12800,556,556,4.162923031,12948.07591,407.92409,407.92409,3.05423847
9,28-03-2022,13279,0,3,12780,499,499,3.757813088,12891.24994,387.75006,387.75006,2.92002455
10,28-03-2022,13143,0,3,12750,393,393,2.990184889,12841.99918,301.00082,301.00082,2.290198737
11,28-03-2022,13078,0,3,12720,358,358,2.737421624,12730.42806,347.57194,347.57194,2.657684202
12,28-03-2022,12993,0,3,12700,293,293,2.255060417,12675.13745,317.86255,317.86255,2.446413838
13,28-03-2022,12900,0,3,12680,220,220,1.705426357,12595.15561,304.84439,304.84439,2.363134806
14,28-03-2022,12795,0,3,12660,135,135,1.055099648,12550.60984,244.39016,244.39016,1.910044236
15,28-03-2022,12680,0,3,12640,40,40,0.315457413,12419.27113,260.72887,260.72887,2.056221372
16,28-03-2022,12667,0,3,12600,67,67,0.528933449,12427.85427,239.14573,239.14573,1.887942923
17,28-03-2022,12665,0,3,12630,35,35,0.276352152,12466.74538,198.25462,198.25462,1.565374023
18,28-03-2022,12559,0,3,12640,-81,81,0.644955809,12505.53241,53.46759,53.46759,0.425731268
19,28-03-2022,12467,0,3,12680,-213,213,1.708510468,12569.52882,-102.52882,102.52882,0.8224017
20,28-03-2022,12507,0,3,12700,-193,193,1.543135844,12635.45212,-128.45212,128.45212,1.027041817
21,28-03-2022,12640,0,3,12780,-140,140,1.107594937,12819.77371,-179.77371,179.77371,1.422260364
22,28-03-2022,12773,0,3,12900,-127,127,0.99428482,12942.51703,-169.51703,169.51703,1.327151257
23,28-03-2022,12920,0,3,13020,-100,100,0.773993808,13114.4526,-194.4526,194.4526,1.505051084
24,28-03-2022,13073,0,3,13100,-27,27,0.206532548,13253.61065,-180.61065,180.61065,1.381554731
25,28-03-2022,13532,0,3,13360,172,172,1.271061188,13638.57186,-106.57186,106.57186,0.78755439
26,28-03-2022,13973,0,3,13750,223,223,1.595935018,14139.02112,-166.02112,166.02112,1.188156588
27,28-03-2022,14385,0,3,14140,245,245,1.703163017,14571.30174,-186.30174,186.30174,1.295111157
28,28-03-2022,14730,0,3,14400,330,330,2.240325866,14872.98985,-142.98985,142.98985,0.970738968
29,28-03-2022,15097,0,3,14530,567,567,3.755713056,15176.44255,-79.44255,79.44255,0.526214149
30,28-03-2022,15271,0,3,14595,676,676,4.426691114,15413.41102,-142.41102,142.41102,0.932558575
31,28-03-2022,15378,0,3,14660,718,718,4.669007673,15644.55151,-266.55151,266.55151,1.733330147
32,28-03-2022,15436,0,3,15300,136,136,0.881057269,15580.91788,-144.91788,144.91788,0.938830526
33,28-03-2022,15403,0,3,15280,123,123,0.798545738,15665.60026,-262.60026,262.60026,1.704864377
34,28-03-2022,15349,0,3,15250,99,99,0.644993159,15613.65909,-264.65909,264.65909,1.724275783
35,28-03-2022,15457,0,3,15220,237,237,1.53328589,15671.45743,-214.45743,214.45743,1.387445365
36,28-03-2022,15615,0,3,15200,415,415,2.657700929,15820.06147,-205.06147,205.06147,1.313233878
37,28-03-2022,15907,0,3,15320,587,587,3.690199283,15863.71879,43.28121,43.28121,0.27208908
38,28-03-2022,16196,0,3,15500,696,696,4.297357372,16111.27564,84.72436,84.72436,0.523119042
39,28-03-2022,16497,0,3,15680,817,817,4.952415591,16271.21281,225.78719,225.78719,1.368656059
40,28-03-2022,16718,0,3,15800,918,918,5.491087451,16533.93505,184.06495,184.06495,1.100998624
41,28-03-2022,16999,0,3,15920,1079,1079,6.347432202,16698.55242,300.44758,300.44758,1.767442673
42,28-03-2022,17074,0,3,16550,524,524,3.068993792,16730.73382,343.26618,343.26618,2.010461403
43,28-03-2022,17061,0,3,16640,421,421,2.467616201,16669.90636,391.09364,391.09364,2.292325421
44,28-03-2022,17049,0,3,16400,649,649,3.806674878,16713.07932,335.92068,335.92068,1.970324828
45,28-03-2022,17077,0,3,16460,617,617,3.613046788,16582.66176,494.33824,494.33824,2.894760438
46,28-03-2022,17089,0,3,16550,539,539,3.154075721,16547.62483,541.37517,541.37517,3.167974545
47,28-03-2022,17085,0,3,16640,445,445,2.604623939,16653.62367,431.37633,431.37633,2.524883406
48,28-03-2022,16845,0,3,16700,145,145,0.860789552,16382.29289,462.70711,462.70711,2.746851351
49,28-03-2022,16623,0,3,16660,-37,37,0.222583168,16361.1749,261.8251,261.8251,1.575077303
50,28-03-2022,16795,0,3,16600,195,195,1.161059839,16441.34699,353.65301,353.65301,2.105704138
51,28-03-2022,16803,0,3,16540,263,263,1.565196691,16626.19831,176.80169,176.80169,1.052203118
52,28-03-2022,16803,0,3,16500,303,303,1.80324942,16324.98813,478.01187,478.01187,2.84480075
53,28-03-2022,16629,0,3,16300,329,329,1.978471345,15991.148,637.852,637.852,3.835780865
54,28-03-2022,16332,0,3,16220,112,112,0.685770267,16209.12532,122.87468,122.87468,0.752355376
55,28-03-2022,16731,0,3,16180,551,551,3.293287909,16314.87759,416.12241,416.12241,2.487134122
56,28-03-2022,16808,0,3,16100,708,708,4.212279867,16353.886,454.114,454.114,2.701772965
57,28-03-2022,16704,0,3,16080,624,624,3.735632184,16400.28763,303.71237,303.71237,1.818201449
58,28-03-2022,16820,0,3,16000,820,820,4.875148633,16355.07531,464.92469,464.92469,2.764118252
59,28-03-2022,16788,0,3,15940,848,848,5.051227067,16261.94543,526.05457,526.05457,3.133515428
60,28-03-2022,16712,0,3,15900,812,812,4.858784107,16231.61345,480.38655,480.38655,2.874500658
61,28-03-2022,16502,0,3,15820,682,682,4.132832384,16143.30462,358.69538,358.69538,2.173647921
62,28-03-2022,16449,0,3,15700,749,749,4.553468296,15831.87572,617.12428,617.12428,3.751743449
63,28-03-2022,16403,0,3,15580,823,823,5.01737487,15837.09714,565.90286,565.90286,3.449996098
64,28-03-2022,16598,0,3,15500,1098,1098,6.61525485,15916.93983,681.06017,681.06017,4.103266478
65,28-03-2022,16605,0,3,15460,1145,1145,6.8955134,16008.86038,596.13962,596.13962,3.590121168
66,28-03-2022,16676,0,3,15400,1276,1276,7.65171504,16113.07964,562.92036,562.92036,3.375631806
67,28-03-2022,16653,0,3,15340,1313,1313,7.884465262,16222.1442,430.8558,430.8558,2.58725635
68,28-03-2022,16792,0,3,15300,1492,1492,8.885183421,16243.06335,548.93665,548.93665,3.269036744
69,28-03-2022,16721,0,3,15320,1401,1401,8.378685485,16223.96052,497.03948,497.03948,2.972546379
70,28-03-2022,16684,0,3,15350,1334,1334,7.995684488,16297.8374,386.1626,386.1626,2.314568449
71,28-03-2022,16365,0,3,15380,985,985,6.018942866,16179.24176,185.75824,185.75824,1.135094653
72,28-03-2022,16420,0,3,15400,1020,1020,6.211936663,16230.16938,189.83062,189.83062,1.15609391
73,28-03-2022,16262,0,3,15300,962,962,5.915631534,16003.78764,258.21236,258.21236,1.58782659
74,28-03-2022,16480,0,3,15500,980,980,5.946601942,16133.20599,346.79401,346.79401,2.104332585
75,28-03-2022,16612,0,3,15700,912,912,5.490007224,16232.00009,379.99991,379.99991,2.287502468
76,28-03-2022,16537,0,3,15800,737,737,4.456672915,16239.15757,297.84243,297.84243,1.80106688
77,28-03-2022,16461,0,3,15600,861,861,5.230544924,16097.04082,363.95918,363.95918,2.211039305
78,28-03-2022,16463,0,3,15400,1063,1063,6.456903359,16021.89579,441.10421,441.10421,2.679367126
79,28-03-2022,16172,0,3,15470,702,702,4.340836013,15978.26076,193.73924,193.73924,1.197991838
80,28-03-2022,16090,0,3,15380,710,710,4.412678682,15791.42971,298.57029,298.57029,1.855626414
81,28-03-2022,15858,0,3,15280,578,578,3.644848026,15556.02621,301.97379,301.97379,1.904236285
82,28-03-2022,15872,0,3,15400,472,472,2.973790323,15464.17983,407.82017,407.82017,2.569431515
83,28-03-2022,15841,0,3,15340,501,501,3.162679124,15403.90717,437.09283,437.09283,2.759250237
84,28-03-2022,15738,0,3,15300,438,438,2.783072817,15414.89726,323.10274,323.10274,2.053010166
85,28-03-2022,15850,0,3,15340,510,510,3.217665615,15413.94319,436.05681,436.05681,2.751147066
86,28-03-2022,15933,0,3,15400,533,533,3.345258269,15488.41079,444.58921,444.58921,2.790367225
87,28-03-2022,15928,0,3,15460,468,468,2.938221999,15532.61262,395.38738,395.38738,2.482341662
88,28-03-2022,15997,0,3,15500,497,497,3.106832531,15468.91917,528.08083,528.08083,3.301124148
89,28-03-2022,15837,0,3,15440,397,397,2.506787902,15398.65843,438.34157,438.34157,2.767832102
90,28-03-2022,15781,0,3,15350,431,431,2.731132374,15464.46468,316.53532,316.53532,2.005800139
91,28-03-2022,15680,0,3,15260,420,420,2.678571429,15393.44269,286.55731,286.55731,1.827533865
92,28-03-2022,15571,0,3,15200,371,371,2.382634384,15163.65549,407.34451,407.34451,2.616045919
93,28-03-2022,15160,0,3,15140,20,20,0.131926121,15154.64822,5.35178,5.35178,0.035301979
94,28-03-2022,15142,0,3,15050,92,92,0.607581561,14920.28888,221.71112,221.71112,1.464212918
95,28-03-2022,14954,0,3,14960,-6,6,0.040123044,14736.75147,217.24853,217.24853,1.452778721
96,28-03-2022,14865,0,3,14900,-35,35,0.235452405,14708.94376,156.05624,156.05624,1.049823343
1,29-03-2022,14696,1,3,14380,316,316,2.150244965,14281.55086,414.44914,414.44914,2.820149292
2,29-03-2022,14543,1,3,14320,223,223,1.533383759,14216.79731,326.20269,326.20269,2.243022004
3,29-03-2022,14530,1,3,14260,270,270,1.858224363,14107.84558,422.15442,422.15442,2.905398624
4,29-03-2022,14533,1,3,14200,333,333,2.291336957,14078.71164,454.28836,454.28836,3.125909035
5,29-03-2022,14482,1,3,14140,342,342,2.361552272,13979.65084,502.34916,502.34916,3.468783041
6,29-03-2022,14396,1,3,14050,346,346,2.403445402,13962.34864,433.65136,433.65136,3.012304529
7,29-03-2022,14336,1,3,13960,376,376,2.622767857,13769.91264,566.08736,566.08736,3.948712054
8,29-03-2022,14316,1,3,13900,416,416,2.90583962,13865.89291,450.10709,450.10709,3.144084172
9,29-03-2022,14200,1,3,13860,340,340,2.394366197,13784.41076,415.58924,415.58924,2.926684789
10,29-03-2022,14093,1,3,13800,293,293,2.079046335,13769.06873,323.93127,323.93127,2.298526006
11,29-03-2022,14041,1,3,13740,301,301,2.143721957,13721.589,319.411,319.411,2.274845097
12,29-03-2022,13988,1,3,13700,288,288,2.058907635,13678.21881,309.78119,309.78119,2.214621032
13,29-03-2022,13800,1,3,13660,140,140,1.014492754,13567.87055,232.12945,232.12945,1.682097464
14,29-03-2022,13696,1,3,13620,76,76,0.554906542,13527.89176,168.10824,168.10824,1.227425818
15,29-03-2022,13593,1,3,13580,13,13,0.09563746,13501.26815,91.73185,91.73185,0.674846244
16,29-03-2022,13488,1,3,13500,-12,12,0.088967972,13495.98665,-7.98665,7.98665,0.059213004
17,29-03-2022,13340,1,3,13530,-190,190,1.424287856,13423.0032,-83.0032,83.0032,0.622212894
18,29-03-2022,13296,1,3,13540,-244,244,1.835138387,13288.63453,7.36547,7.36547,0.055396134
19,29-03-2022,13305,1,3,13580,-275,275,2.066892146,13291.4236,13.5764,13.5764,0.102039835
20,29-03-2022,13355,1,3,13600,-245,245,1.834518907,13275.72068,79.27932,79.27932,0.593630251
21,29-03-2022,13454,1,3,13680,-226,226,1.67979783,13437.20266,16.79734,16.79734,0.124850156
22,29-03-2022,13499,1,3,13800,-301,301,2.2297948,13541.81224,-42.81224,42.81224,0.317151196
23,29-03-2022,13661,1,3,13920,-259,259,1.895908059,13678.01863,-17.01863,17.01863,0.124578215
24,29-03-2022,13835,1,3,14000,-165,165,1.192627394,13802.3962,32.6038,32.6038,0.235661728
25,29-03-2022,14221,1,3,14200,21,21,0.14766894,14100.8157,120.1843,120.1843,0.845118487
26,29-03-2022,14616,1,3,14500,116,116,0.793650794,14678.43105,-62.43105,62.43105,0.427141831
27,29-03-2022,15168,1,3,14800,368,368,2.426160338,15115.92628,52.07372,52.07372,0.343313027
28,29-03-2022,15488,1,3,15000,488,488,3.150826446,15473.6105,14.3895,14.3895,0.092907412
29,29-03-2022,15812,1,3,15100,712,712,4.502909183,15823.07301,-11.07301,11.07301,0.070029155
30,29-03-2022,15947,1,3,15150,797,797,4.99780523,16028.07394,-81.07394,81.07394,0.508396187
31,29-03-2022,15999,1,3,15200,799,799,4.994062129,16119.59667,-120.59667,120.59667,0.753776299
32,29-03-2022,15898,1,3,16000,-102,102,0.641590137,15925.96422,-27.96422,27.96422,0.175897723
33,29-03-2022,15711,1,3,15980,-269,269,1.712176182,15752.14493,-41.14493,41.14493,0.261886131
34,29-03-2022,15670,1,3,15950,-280,280,1.786853861,15698.17794,-28.17794,28.17794,0.179820932
35,29-03-2022,15774,1,3,15920,-146,146,0.925573729,15680.88032,93.11968,93.11968,0.590336503
36,29-03-2022,15954,1,3,15900,54,54,0.33847311,15695.91511,258.08489,258.08489,1.617681397
37,29-03-2022,16191,1,3,16100,91,91,0.56204064,15629.3942,561.6058,561.6058,3.468629486
38,29-03-2022,16527,1,3,16400,127,127,0.768439523,15935.24022,591.75978,591.75978,3.580563805
39,29-03-2022,16748,1,3,16700,48,48,0.286601385,16259.19709,488.80291,488.80291,2.918574815
40,29-03-2022,17063,1,3,16900,163,163,0.955283362,16514.79379,548.20621,548.20621,3.212836019
41,29-03-2022,17144,1,3,16940,204,204,1.189920672,16629.95548,514.04452,514.04452,2.99839314
42,29-03-2022,17161,1,3,17000,161,161,0.938173766,16592.39502,568.60498,568.60498,3.313355748
43,29-03-2022,17106,1,3,16940,166,166,0.970419736,16541.76308,564.23692,564.23692,3.298473752
44,29-03-2022,17218,1,3,17100,118,118,0.685329307,16609.36175,608.63825,608.63825,3.534895168
45,29-03-2022,17072,1,3,17060,12,12,0.070290534,16612.92421,459.07579,459.07579,2.689056877
46,29-03-2022,17117,1,3,17000,117,117,0.683530993,16508.07338,608.92662,608.92662,3.557437752
47,29-03-2022,17023,1,3,16940,83,83,0.487575633,16580.85962,442.14038,442.14038,2.597311755
48,29-03-2022,17014,1,3,16900,114,114,0.670036441,16425.30856,588.69144,588.69144,3.460041378
49,29-03-2022,16837,1,3,16840,-3,3,0.017817901,16306.50446,530.49554,530.49554,3.150772347
50,29-03-2022,16778,1,3,16750,28,28,0.166885207,16402.19861,375.80139,375.80139,2.239846168
51,29-03-2022,17136,1,3,16660,476,476,2.777777778,16475.6938,660.3062,660.3062,3.853327498
52,29-03-2022,17023,1,3,16600,423,423,2.484873407,16365.59333,657.40667,657.40667,3.861873172
53,29-03-2022,16710,1,3,16400,310,310,1.855176541,16059.2538,650.7462,650.7462,3.894351885
54,29-03-2022,16832,1,3,16320,512,512,3.041825095,16153.20909,678.79091,678.79091,4.032740673
55,29-03-2022,16911,1,3,16280,631,631,3.731299154,16133.72645,777.27355,777.27355,4.596260127
56,29-03-2022,16786,1,3,16200,586,586,3.491004408,16153.1982,632.8018,632.8018,3.769818897
57,29-03-2022,16876,1,3,16180,696,696,4.124200047,16241.57024,634.42976,634.42976,3.759360986
58,29-03-2022,16756,1,3,16100,656,656,3.915015517,16180.94679,575.05321,575.05321,3.431924147
59,29-03-2022,16762,1,3,16040,722,722,4.30736189,16300.08445,461.91555,461.91555,2.755730521
60,29-03-2022,16845,1,3,16000,845,845,5.016325319,16197.53061,647.46939,647.46939,3.843688869
61,29-03-2022,16687,1,3,15980,707,707,4.236831066,16011.68375,675.31625,675.31625,4.046960209
62,29-03-2022,16604,1,3,15950,654,654,3.938809925,16006.33219,597.66781,597.66781,3.599541135
63,29-03-2022,16539,1,3,15920,619,619,3.742668843,15793.2786,745.7214,745.7214,4.508866316
64,29-03-2022,16610,1,3,15900,710,710,4.274533414,16021.05808,588.94192,588.94192,3.545706924
65,29-03-2022,16661,1,3,15860,801,801,4.807634596,16059.71302,601.28698,601.28698,3.608948923
66,29-03-2022,16725,1,3,15800,925,925,5.53064275,16170.75908,554.24092,554.24092,3.313847055
67,29-03-2022,16813,1,3,15740,1073,1073,6.381966336,16268.833,544.167,544.167,3.236584786
68,29-03-2022,16717,1,3,15700,1017,1017,6.083627445,16301.33104,415.66896,415.66896,2.486504516
69,29-03-2022,16385,1,3,15760,625,625,3.814464449,16189.72721,195.27279,195.27279,1.191777785
70,29-03-2022,16490,1,3,15850,640,640,3.881140085,16258.44928,231.55072,231.55072,1.40418872
71,29-03-2022,16360,1,3,15940,420,420,2.567237164,16134.86095,225.13905,225.13905,1.376155562
72,29-03-2022,16133,1,3,16000,133,133,0.824397198,16172.77515,-39.77515,39.77515,0.24654528
73,29-03-2022,16259,1,3,16000,259,259,1.592963897,16002.53183,256.46817,256.46817,1.577392029
74,29-03-2022,16473,1,3,16200,273,273,1.65725733,16140.88365,332.11635,332.11635,2.016125478
75,29-03-2022,16643,1,3,16400,243,243,1.460073304,16315.70079,327.29921,327.29921,1.966587815
76,29-03-2022,16453,1,3,16500,-47,47,0.285662189,16264.03236,188.96764,188.96764,1.148529995
77,29-03-2022,16199,1,3,16300,-101,101,0.623495277,16126.83804,72.16196,72.16196,0.445471696
78,29-03-2022,16130,1,3,16100,30,30,0.185988841,16015.88776,114.11224,114.11224,0.707453441
79,29-03-2022,16078,1,3,15950,128,128,0.79611892,15885.07883,192.92117,192.92117,1.199907762
80,29-03-2022,15913,1,3,15890,23,23,0.144535914,15740.78301,172.21699,172.21699,1.082240872
81,29-03-2022,15880,1,3,15790,90,90,0.56675063,15452.01557,427.98443,427.98443,2.695116058
82,29-03-2022,15804,1,3,15950,-146,146,0.923816755,15408.12368,395.87632,395.87632,2.504912174
83,29-03-2022,15866,1,3,15920,-54,54,0.340350435,15359.2585,506.7415,506.7415,3.193883146
84,29-03-2022,15910,1,3,15900,10,10,0.062853551,15316.80497,593.19503,593.19503,3.72844142
85,29-03-2022,15868,1,3,15920,-52,52,0.327703554,15273.95303,594.04697,594.04697,3.743678914
86,29-03-2022,15983,1,3,15950,33,33,0.206469374,15389.64507,593.35493,593.35493,3.712412751
87,29-03-2022,16010,1,3,15980,30,30,0.187382886,15393.46338,616.53662,616.53662,3.850947033
88,29-03-2022,15996,1,3,16000,-4,4,0.025006252,15284.33334,711.66666,711.66666,4.449028882
89,29-03-2022,15901,1,3,15880,21,21,0.132067166,15163.60191,737.39809,737.39809,4.637432174
90,29-03-2022,15834,1,3,15700,134,134,0.846280157,15129.2616,704.7384,704.7384,4.450791967
91,29-03-2022,15666,1,3,15520,146,146,0.931954551,15078.09969,587.90031,587.90031,3.75271486
92,29-03-2022,15475,1,3,15400,75,75,0.484652666,14898.88137,576.11863,576.11863,3.722899063
93,29-03-2022,15154,1,3,15320,-166,166,1.095420351,14721.98721,432.01279,432.01279,2.85081688
94,29-03-2022,15024,1,3,15200,-176,176,1.171458999,14572.10241,451.89759,451.89759,3.007838059
95,29-03-2022,14819,1,3,15080,-261,261,1.761252446,14445.19853,373.80147,373.80147,2.522447331
96,29-03-2022,14778,1,3,15000,-222,222,1.502233049,14418.46458,359.53542,359.53542,2.432909866
1,30-03-2022,14573,2,3,14820,-247,247,1.694915254,14596.81028,-23.81028,23.81028,0.163386262
2,30-03-2022,14657,2,3,14780,-123,123,0.839189466,14445.98675,211.01325,211.01325,1.439675582
3,30-03-2022,14527,2,3,14740,-213,213,1.466235286,14445.62652,81.37348,81.37348,0.56015337
4,30-03-2022,14453,2,3,14700,-247,247,1.708987753,14477.51263,-24.51263,24.51263,0.169602366
5,30-03-2022,14368,2,3,14660,-292,292,2.032293987,14385.41834,-17.41834,17.41834,0.121230095
6,30-03-2022,14297,2,3,14600,-303,303,2.119325733,14277.09048,19.90952,19.90952,0.139256627
7,30-03-2022,14256,2,3,14540,-284,284,1.992143659,14153.50095,102.49905,102.49905,0.718988847
8,30-03-2022,14188,2,3,14500,-312,312,2.199041443,14213.89968,-25.89968,25.89968,0.182546377
9,30-03-2022,14140,2,3,14420,-280,280,1.98019802,14074.49263,65.50737,65.50737,0.463277016
10,30-03-2022,14165,2,3,14300,-135,135,0.9530533,13979.98731,185.01269,185.01269,1.306125591
11,30-03-2022,13947,2,3,14180,-233,233,1.670610167,13924.80092,22.19908,22.19908,0.15916742
12,30-03-2022,13832,2,3,14100,-268,268,1.937536148,13885.27735,-53.27735,53.27735,0.385174595
13,30-03-2022,13670,2,3,14020,-350,350,2.560351134,13742.22894,-72.22894,72.22894,0.528375567
14,30-03-2022,13553,2,3,13940,-387,387,2.855456357,13612.10193,-59.10193,59.10193,0.436080056
15,30-03-2022,13520,2,3,13860,-340,340,2.514792899,13498.63324,21.36676,21.36676,0.158038166
16,30-03-2022,13333,2,3,13700,-367,367,2.752568814,13442.31096,-109.31096,109.31096,0.819852696
17,30-03-2022,13309,2,3,13700,-391,391,2.937861597,13327.16618,-18.16618,18.16618,0.136495454
18,30-03-2022,13330,2,3,13700,-370,370,2.775693923,13328.79871,1.20129,1.20129,0.009011928
19,30-03-2022,13243,2,3,13700,-457,457,3.45087971,13337.52405,-94.52405,94.52405,0.713766141
20,30-03-2022,13305,2,3,13700,-395,395,2.968808719,13378.5557,-73.5557,73.5557,0.55284254
21,30-03-2022,13414,2,3,13760,-346,346,2.579394662,13482.76485,-68.76485,68.76485,0.512634934
22,30-03-2022,13543,2,3,13850,-307,307,2.266853725,13507.22593,35.77407,35.77407,0.264151739
23,30-03-2022,13657,2,3,13940,-283,283,2.072197408,13709.23575,-52.23575,52.23575,0.382483342
24,30-03-2022,13878,2,3,14000,-122,122,0.879089206,13827.28801,50.71199,50.71199,0.365412812
25,30-03-2022,14283,2,3,14300,-17,17,0.119022614,14273.95574,9.04426,9.04426,0.063321851
26,30-03-2022,14663,2,3,14750,-87,87,0.593330151,14667.15267,-4.15267,4.15267,0.028320739
27,30-03-2022,14963,2,3,15200,-237,237,1.583906971,15126.36255,-163.36255,163.36255,1.091776716
28,30-03-2022,15255,2,3,15500,-245,245,1.60603081,15366.42127,-111.42127,111.42127,0.730391806
29,30-03-2022,15725,2,3,15650,75,75,0.476947536,15628.11977,96.88023,96.88023,0.616090493
30,30-03-2022,15855,2,3,15725,130,130,0.819930621,15799.77293,55.22707,55.22707,0.348325891
31,30-03-2022,15956,2,3,15800,156,156,0.977688644,15878.23373,77.76627,77.76627,0.487379481
32,30-03-2022,15831,2,3,16200,-369,369,2.330869812,15794.6137,36.3863,36.3863,0.229842082
33,30-03-2022,15666,2,3,16140,-474,474,3.025660666,15606.20533,59.79467,59.79467,0.381684348
34,30-03-2022,15602,2,3,16050,-448,448,2.87142674,15522.88743,79.11257,79.11257,0.50706685
35,30-03-2022,15600,2,3,15960,-360,360,2.307692308,15531.62745,68.37255,68.37255,0.438285577
36,30-03-2022,15690,2,3,15900,-210,210,1.338432122,15713.27641,-23.27641,23.27641,0.14835188
37,30-03-2022,15640,2,3,16120,-480,480,3.069053708,16071.44685,-431.44685,431.44685,2.758611573
38,30-03-2022,16051,2,3,16450,-399,399,2.485826428,16466.56652,-415.56652,415.56652,2.589038191
39,30-03-2022,16332,2,3,16780,-448,448,2.743081068,16721.96959,-389.96959,389.96959,2.387763838
40,30-03-2022,16519,2,3,17000,-481,481,2.911798535,16903.92223,-384.92223,384.92223,2.330178764
41,30-03-2022,16678,2,3,17080,-402,402,2.410360955,16991.26737,-313.26737,313.26737,1.878326958
42,30-03-2022,16843,2,3,17250,-407,407,2.416434127,17002.93485,-159.93485,159.93485,0.949562726
43,30-03-2022,16814,2,3,17160,-346,346,2.057808969,16936.01265,-122.01265,122.01265,0.725661056
44,30-03-2022,16716,2,3,17400,-684,684,4.091888011,16989.60554,-273.60554,273.60554,1.636788346
45,30-03-2022,16539,2,3,17340,-801,801,4.843098132,16782.53463,-243.53463,243.53463,1.472487031
46,30-03-2022,16580,2,3,17250,-670,670,4.041013269,16896.39817,-316.39817,316.39817,1.908312244
47,30-03-2022,16424,2,3,17160,-736,736,4.481246956,16878.49118,-454.49118,454.49118,2.767238066
48,30-03-2022,16181,2,3,17100,-919,919,5.679500649,16772.02226,-591.02226,591.02226,3.652569433
49,30-03-2022,16018,2,3,17080,-1062,1062,6.630041204,16619.00956,-601.00956,601.00956,3.75208865
50,30-03-2022,16139,2,3,17050,-911,911,5.644711568,16643.30117,-504.30117,504.30117,3.124736167
51,30-03-2022,15924,2,3,17020,-1096,1096,6.882692791,16909.02551,-985.02551,985.02551,6.185791949
52,30-03-2022,15963,2,3,17000,-1037,1037,6.49627263,16860.01742,-897.01742,897.01742,5.61935363
53,30-03-2022,15837,2,3,16900,-1063,1063,6.712129823,16633.10327,-796.10327,796.10327,5.026856538
54,30-03-2022,15769,2,3,16860,-1091,1091,6.918637834,16751.3349,-982.3349,982.3349,6.229531993
55,30-03-2022,15886,2,3,16840,-954,954,6.005287675,16789.16142,-903.16142,903.16142,5.685266398
56,30-03-2022,15949,2,3,16800,-851,851,5.335757728,16458.98208,-509.98208,509.98208,3.197580287
57,30-03-2022,15914,2,3,16800,-886,886,5.567424909,16543.54489,-629.54489,629.54489,3.955918625
58,30-03-2022,16077,2,3,16800,-723,723,4.497107669,16449.71649,-372.71649,372.71649,2.318321142
59,30-03-2022,16265,2,3,16800,-535,535,3.289271442,16518.51139,-253.51139,253.51139,1.558631356
60,30-03-2022,16086,2,3,16800,-714,714,4.438642298,16640.53259,-554.53259,554.53259,3.447299453
61,30-03-2022,15841,2,3,16780,-939,939,5.927656082,16522.39886,-681.39886,681.39886,4.301488921
62,30-03-2022,15788,2,3,16750,-962,962,6.093235369,16348.64324,-560.64324,560.64324,3.551071953
63,30-03-2022,15942,2,3,16720,-778,778,4.880190691,16303.93298,-361.93298,361.93298,2.270311002
64,30-03-2022,16093,2,3,16700,-607,607,3.77182626,16333.1263,-240.1263,240.1263,1.492116448
65,30-03-2022,16216,2,3,16720,-504,504,3.108041441,16314.58688,-98.58688,98.58688,0.607960533
66,30-03-2022,16248,2,3,16750,-502,502,3.089611029,16351.53832,-103.53832,103.53832,0.637237322
67,30-03-2022,16158,2,3,16780,-622,622,3.849486323,16401.71717,-243.71717,243.71717,1.50833748
68,30-03-2022,16144,2,3,16800,-656,656,4.063429138,16362.8663,-218.8663,218.8663,1.355712958
69,30-03-2022,15958,2,3,16740,-782,782,4.900363454,16111.29652,-153.29652,153.29652,0.96062489
70,30-03-2022,15758,2,3,16650,-892,892,5.66061683,16220.75936,-462.75936,462.75936,2.936663028
71,30-03-2022,15576,2,3,16560,-984,984,6.317411402,16066.77295,-490.77295,490.77295,3.150827876
72,30-03-2022,15599,2,3,16500,-901,901,5.776011283,15861.75753,-262.75753,262.75753,1.684451119
73,30-03-2022,15617,2,3,16300,-683,683,4.373439201,16022.56733,-405.56733,405.56733,2.596960556
74,30-03-2022,16009,2,3,16500,-491,491,3.067024799,16300.96261,-291.96261,291.96261,1.823740458
75,30-03-2022,16044,2,3,16700,-656,656,4.088755921,16398.125,-354.125,354.125,2.207211419
76,30-03-2022,16019,2,3,16800,-781,781,4.875460391,16209.03007,-190.03007,190.03007,1.186279231
77,30-03-2022,16113,2,3,16600,-487,487,3.02240427,15924.4139,188.5861,188.5861,1.170397195
78,30-03-2022,16122,2,3,16400,-278,278,1.724351817,15862.64143,259.35857,259.35857,1.608724538
79,30-03-2022,15981,2,3,16140,-159,159,0.994931481,15816.2405,164.7595,164.7595,1.030971153
80,30-03-2022,15886,2,3,16070,-184,184,1.158252549,15668.77802,217.22198,217.22198,1.367379957
81,30-03-2022,15786,2,3,15970,-184,184,1.165589763,15555.13714,230.86286,230.86286,1.462453186
82,30-03-2022,15733,2,3,16050,-317,317,2.014873196,15531.75768,201.24232,201.24232,1.279109642
83,30-03-2022,15700,2,3,15960,-260,260,1.656050955,15617.96577,82.03423,82.03423,0.522511019
84,30-03-2022,15786,2,3,15900,-114,114,0.722158875,15636.12409,149.87591,149.87591,0.94942297
85,30-03-2022,15834,2,3,15940,-106,106,0.669445497,15603.53295,230.46705,230.46705,1.455520083
86,30-03-2022,15853,2,3,16000,-147,147,0.927269287,15740.66974,112.33026,112.33026,0.70857415
87,30-03-2022,15865,2,3,16060,-195,195,1.229120706,15816.37087,48.62913,48.62913,0.306518311
88,30-03-2022,15891,2,3,16100,-209,209,1.315209867,15796.87896,94.12104,94.12104,0.592291486
89,30-03-2022,15808,2,3,16020,-212,212,1.341093117,15723.20619,84.79381,84.79381,0.53639809
90,30-03-2022,15828,2,3,15900,-72,72,0.454890068,15722.96651,105.03349,105.03349,0.663592937
91,30-03-2022,15590,2,3,15780,-190,190,1.218729955,15517.14355,72.85645,72.85645,0.467328095
92,30-03-2022,15457,2,3,15700,-243,243,1.572103254,15329.84511,127.15489,127.15489,0.822636281
93,30-03-2022,15225,2,3,15560,-335,335,2.200328407,15068.36774,156.63226,156.63226,1.028783317
94,30-03-2022,14960,2,3,15350,-390,390,2.606951872,14945.24608,14.75392,14.75392,0.09862246
95,30-03-2022,14859,2,3,15140,-281,281,1.891109765,14812.56157,46.43843,46.43843,0.31252729
96,30-03-2022,14672,2,3,15000,-328,328,2.235550709,14705.12559,-33.12559,33.12559,0.225774196
1,31-03-2022,14445,3,3,14680,-235,235,1.626860505,14488.15452,-43.15452,43.15452,0.298750571
2,31-03-2022,14401,3,3,14620,-219,219,1.520727727,14567.84309,-166.84309,166.84309,1.158552114
3,31-03-2022,14224,3,3,14560,-336,336,2.362204724,14425.90282,-201.90282,201.90282,1.419451772
4,31-03-2022,14158,3,3,14500,-342,342,2.415595423,14328.29075,-170.29075,170.29075,1.202788176
5,31-03-2022,14214,3,3,14440,-226,226,1.589981708,14250.05995,-36.05995,36.05995,0.25369319
6,31-03-2022,14133,3,3,14350,-217,217,1.535413571,14177.18566,-44.18566,44.18566,0.31264176
7,31-03-2022,14100,3,3,14260,-160,160,1.134751773,14071.69144,28.30856,28.30856,0.200769929
8,31-03-2022,14071,3,3,14200,-129,129,0.916779191,13988.25567,82.74433,82.74433,0.588048682
9,31-03-2022,13964,3,3,14140,-176,176,1.260383844,13932.40673,31.59327,31.59327,0.226247995
10,31-03-2022,14015,3,3,14050,-35,35,0.24973243,13974.01316,40.98684,40.98684,0.292449804
11,31-03-2022,13951,3,3,13960,-9,9,0.064511505,13802.55558,148.44442,148.44442,1.064041431
12,31-03-2022,13874,3,3,13900,-26,26,0.187400894,13682.97904,191.02096,191.02096,1.37682687
13,31-03-2022,13777,3,3,13840,-63,63,0.457283879,13533.76677,243.23323,243.23323,1.765502141
14,31-03-2022,13691,3,3,13780,-89,89,0.650062085,13444.31821,246.68179,246.68179,1.801780659
15,31-03-2022,13605,3,3,13720,-115,115,0.845277472,13448.40339,156.59661,156.59661,1.151022492
16,31-03-2022,13545,3,3,13600,-55,55,0.406053894,13287.72461,257.27539,257.27539,1.899412255
17,31-03-2022,13325,3,3,13540,-215,215,1.613508443,13238.90901,86.09099,86.09099,0.646086229
18,31-03-2022,13322,3,3,13520,-198,198,1.486263324,13200.11822,121.88178,121.88178,0.914891007
19,31-03-2022,13260,3,3,13440,-180,180,1.357466063,13080.06242,179.93758,179.93758,1.356995324
20,31-03-2022,13284,3,3,13400,-116,116,0.873230955,13211.46023,72.53977,72.53977,0.546068729
21,31-03-2022,13431,3,3,13500,-69,69,0.513736877,13279.40609,151.59391,151.59391,1.128686695
22,31-03-2022,13580,3,3,13650,-70,70,0.515463918,13401.29471,178.70529,178.70529,1.315944698
23,31-03-2022,13670,3,3,13800,-130,130,0.950987564,13478.26352,191.73648,191.73648,1.402607754
24,31-03-2022,13828,3,3,13900,-72,72,0.520682673,13742.02449,85.97551,85.97551,0.621749421
25,31-03-2022,14249,3,3,14180,69,69,0.484244508,14122.79575,126.20425,126.20425,0.885706014
26,31-03-2022,14719,3,3,14600,119,119,0.808478837,14532.25552,186.74448,186.74448,1.268730756
27,31-03-2022,15027,3,3,15020,7,7,0.046582818,14869.35633,157.64367,157.64367,1.049069475
28,31-03-2022,15398,3,3,15300,98,98,0.636446292,15297.85028,100.14972,100.14972,0.650407326
29,31-03-2022,15604,3,3,15440,164,164,1.051012561,15855.24133,-251.24133,251.24133,1.610108498
30,31-03-2022,15783,3,3,15510,273,273,1.729709181,15962.90397,-179.90397,179.90397,1.139859152
31,31-03-2022,15872,3,3,15580,292,292,1.839717742,15966.31468,-94.31468,94.31468,0.594220514
32,31-03-2022,15785,3,3,16000,-215,215,1.362052582,15828.69238,-43.69238,43.69238,0.276796832
33,31-03-2022,15710,3,3,15920,-210,210,1.336728199,15752.47385,-42.47385,42.47385,0.270361871
34,31-03-2022,15586,3,3,15800,-214,214,1.373027076,15691.48044,-105.48044,105.48044,0.676764019
35,31-03-2022,15701,3,3,15680,21,21,0.133749443,15733.08098,-32.08098,32.08098,0.204324438
36,31-03-2022,15746,3,3,15600,146,146,0.927219611,15808.40959,-62.40959,62.40959,0.396352026
37,31-03-2022,15828,3,3,15820,8,8,0.050543341,15665.11197,162.88803,162.88803,1.029113154
38,31-03-2022,16126,3,3,16150,-24,24,0.14882798,15987.8174,138.1826,138.1826,0.856893216
39,31-03-2022,16503,3,3,16480,23,23,0.1393686,16278.17606,224.82394,224.82394,1.362321638
40,31-03-2022,16753,3,3,16700,53,53,0.316361249,16485.63808,267.36192,267.36192,1.595904733
41,31-03-2022,16786,3,3,16800,-14,14,0.083402836,16719.21235,66.78765,66.78765,0.3978771
42,31-03-2022,16847,3,3,17050,-203,203,1.204962308,16840.52877,6.47123,6.47123,0.038411765
43,31-03-2022,16684,3,3,16960,-276,276,1.654279549,16775.7198,-91.7198,91.7198,0.549747063
44,31-03-2022,16831,3,3,17200,-369,369,2.192383103,16756.63436,74.36564,74.36564,0.441837324
45,31-03-2022,17099,3,3,17140,-41,41,0.239780104,16783.09801,315.90199,315.90199,1.847488099
46,31-03-2022,16720,3,3,17050,-330,330,1.973684211,16709.48142,10.51858,10.51858,0.062910167
47,31-03-2022,16780,3,3,16960,-180,180,1.072705602,16488.68317,291.31683,291.31683,1.73609553
48,31-03-2022,16464,3,3,16900,-436,436,2.648202138,16263.02497,200.97503,200.97503,1.220693817
49,31-03-2022,16525,3,3,16880,-355,355,2.148260212,16138.70455,386.29545,386.29545,2.337642663
50,31-03-2022,16593,3,3,16850,-257,257,1.548845899,16236.97156,356.02844,356.02844,2.145654433
51,31-03-2022,16716,3,3,16820,-104,104,0.622158411,16021.35397,694.64603,694.64603,4.155575676
52,31-03-2022,16614,3,3,16800,-186,186,1.119537739,15987.17198,626.82802,626.82802,3.772890454
53,31-03-2022,16484,3,3,16750,-266,266,1.613685999,15793.30188,690.69812,690.69812,4.190112351
54,31-03-2022,16368,3,3,16730,-362,362,2.211632454,15720.486,647.514,647.514,3.955975073
55,31-03-2022,16370,3,3,16720,-350,350,2.138057422,15899.27282,470.72718,470.72718,2.875547831
56,31-03-2022,16455,3,3,16700,-245,245,1.488909146,16101.82311,353.17689,353.17689,2.146319599
57,31-03-2022,16583,3,3,16700,-117,117,0.70554182,16070.95812,512.04188,512.04188,3.087751794
58,31-03-2022,16716,3,3,16700,16,16,0.095716679,16233.53496,482.46504,482.46504,2.886246949
59,31-03-2022,16590,3,3,16700,-110,110,0.66305003,16365.07008,224.92992,224.92992,1.355816275
60,31-03-2022,16417,3,3,16700,-283,283,1.723822867,16194.13714,222.86286,222.86286,1.3575127
61,31-03-2022,16530,3,3,16700,-170,170,1.028433152,15932.89342,597.10658,597.10658,3.612260012
62,31-03-2022,16398,3,3,16700,-302,302,1.841688011,15771.37392,626.62608,626.62608,3.821356751
63,31-03-2022,16302,3,3,16700,-398,398,2.441418231,15995.68689,306.31311,306.31311,1.878990983
64,31-03-2022,16317,3,3,16700,-383,383,2.347245204,16160.9198,156.0802,156.0802,0.956549611
65,31-03-2022,16204,3,3,16700,-496,496,3.060972599,16381.73662,-177.73662,177.73662,1.096868798
66,31-03-2022,16274,3,3,16700,-426,426,2.617672361,16458.98423,-184.98423,184.98423,1.136685695
67,31-03-2022,16386,3,3,16700,-314,314,1.916269987,16434.72019,-48.72019,48.72019,0.297328146
68,31-03-2022,16216,3,3,16700,-484,484,2.984706463,16454.48363,-238.48363,238.48363,1.470668661
69,31-03-2022,16183,3,3,16620,-437,437,2.70036458,16270.27783,-87.27783,87.27783,0.539317988
70,31-03-2022,16206,3,3,16500,-294,294,1.81414291,16046.57832,159.42168,159.42168,0.983720104
71,31-03-2022,16148,3,3,16380,-232,232,1.436710429,15908.24851,239.75149,239.75149,1.484713215
72,31-03-2022,16061,3,3,16300,-239,239,1.488076708,15912.33292,148.66708,148.66708,0.925640247
73,31-03-2022,15897,3,3,16300,-403,403,2.53506951,15931.57261,-34.57261,34.57261,0.217478832
74,31-03-2022,16129,3,3,16500,-371,371,2.3002046,16273.11372,-144.11372,144.11372,0.893506851
75,31-03-2022,16250,3,3,16700,-450,450,2.769230769,16325.47157,-75.47157,75.47157,0.464440431
76,31-03-2022,16203,3,3,16800,-597,597,3.68450287,16355.8033,-152.8033,152.8033,0.943055607
77,31-03-2022,16083,3,3,16600,-517,517,3.214574395,16487.33869,-404.33869,404.33869,2.514075048
78,31-03-2022,16010,3,3,16400,-390,390,2.435977514,16505.807,-495.807,495.807,3.096858214
79,31-03-2022,15918,3,3,15920,-2,2,0.012564393,16297.7191,-379.7191,379.7191,2.385469908
80,31-03-2022,15778,3,3,15890,-112,112,0.709849157,16161.39752,-383.39752,383.39752,2.429950057
81,31-03-2022,15732,3,3,15790,-58,58,0.368675311,16030.11633,-298.11633,298.11633,1.894967773
82,31-03-2022,15817,3,3,15950,-133,133,0.840867421,15999.07296,-182.07296,182.07296,1.151121957
83,31-03-2022,15674,3,3,15920,-246,246,1.569478117,15961.63666,-287.63666,287.63666,1.835119689
84,31-03-2022,15743,3,3,15900,-157,157,0.997268627,16040.65585,-297.65585,297.65585,1.890718732
85,31-03-2022,15724,3,3,15920,-196,196,1.246502162,16072.38102,-348.38102,348.38102,2.215600483
86,31-03-2022,15898,3,3,15950,-52,52,0.327085168,16068.59046,-170.59046,170.59046,1.073030947
87,31-03-2022,15954,3,3,15980,-26,26,0.162968535,16002.36391,-48.36391,48.36391,0.303145982
88,31-03-2022,16024,3,3,16000,24,24,0.149775337,15973.56855,50.43145,50.43145,0.314724476
89,31-03-2022,15944,3,3,15900,44,44,0.275965881,15893.76256,50.23744,50.23744,0.315086804
90,31-03-2022,15878,3,3,15750,128,128,0.80614687,15870.6393,7.3607,7.3607,0.046357854
91,31-03-2022,15816,3,3,15600,216,216,1.365705615,15590.57429,225.42571,225.42571,1.425301657
92,31-03-2022,15645,3,3,15500,145,145,0.926813678,15455.61166,189.38834,189.38834,1.21053589
93,31-03-2022,15473,3,3,15380,93,93,0.601046985,15261.33135,211.66865,211.66865,1.367987139
94,31-03-2022,15426,3,3,15200,226,226,1.465058991,14965.27089,460.72911,460.72911,2.986704979
95,31-03-2022,15230,3,3,15020,210,210,1.378857518,14903.72932,326.27068,326.27068,2.142289429
96,31-03-2022,15115,3,3,14900,215,215,1.422428052,14678.60079,436.39921,436.39921,2.887192921
